border_size=1
usage=map

Ms, Ms^Xm, Ms^Xm, Ms, Ms, Ms^Xm, Ms^Xm, Ms^Xm, Ms, Ms, Ms^Xm, Ms, Ms^Xm, Ms, Ms^Xm, Ms, Ms, Ms, Ms^Xm, Ms^Xm, Ms^Xm, Ms^Xm, Ms^Xm, Ms^Xm, Ms^Xm, Ms^Xm, Ms, Ms, Ms, Ms, Ha, Ha, Ha^Fpa, Gd, Aa, Aa, Ha, Aa, Aa^Fma, Ha^Fma, Ha, Ha, Ha^Fma, Ms^Xm, Ms^Xm, Gd, Ms, Ms, Ms, Ms, Ms^Xm, Ms, Ms, Ms, Ms, Ms^Xm, Ms^Xm, Ms^Xm, Ms^Xm, Gd, Ms^Xm, Gd, Ms^Xm, Ms^Xm, Ms^Xm, Ms, Ms, Ms, Ms, Ms
Ms^Xm, Ms^Xm, Ms^Xm, Ms, Ms^Xm, Ms^Xm, Ms^Xm, Ms^Xm, Ms^Xm, Ms, Ms, Ms^Xm, Ms, Ms^Xm, Ms, Ms, Ms, Ms^Xm, Ms^Xm, Ms^Xm, Ms^Xm, Ms^Xm, Ms, Ms^Xm, Ms^Xm, Ms^Xm, Ms, Ms, Ms, Ms, Ha, Ha, Ha, Aa, Aa, Aa, Aa, Ha, Aa, Ha^Fma, Ha^Fma, Ha^Fma, Ha^Fma, Ha, Ms^Xm, Ms^Xm, Ms^Xm, Ms, Ms, Ms, Ms, Ms^Xm, Ms^Xm, Ms^Xm, Ms, Ms^Xm, Ms^Xm, Ms^Xm, Ai, Ms^Xm, Ms^Xm, Ms^Xm, Ms^Xm, Ms^Xm, Ms^Xm, Ms, Ms, Ms, Ha, Ha
Ms^Xm, Ms^Xm, Ms, Ms^Xm, Ms, Ms^Xm, Ms^Xm, Ms^Xm, Ms, Ms, Ms, Ms^Xm, Ms^Xm, Ms^Xm, Ms^Xm, Ms, Ms^Xm, Ms, Ms^Xm, Ms^Xm, Ms, Ms, Ms, Ms, Ms, Ms^Xm, Ms^Xm, Ms, Ms, Ms, Ha, Ha^Fpa, Ha^Fpa, Ha^Vha, Gd, Gd, Aa, Ha, Aa, Aa, Aa, Ha^Fma, Ha^Fma, Ha, Ha, Ms^Xm, Ms^Xm, Ms^Xm, Ms^Xm, Ms, Ha, Ms, Ms, Ms^Xm, Ms, Ms^Xm, Ms, Ai, Ms^Xm, Ms^Xm, Ms^Xm, Ms^Xm, Ms^Xm, Ms^Xm, Ms, Ms^Xm, Ms^Xm, Ms, Ha^Fpa, Ha^Fpa
Ms^Xm, Ms^Xm, Ms^Xm, Ms^Xm, Ms^Xm, Ms^Xm, Ms^Xm, Ms^Xm, Ms, Ms, Ms, Ms, Ms^Xm, Ms, Ms, Ms, Ms, Ms^Xm, Ms^Xm, Ms^Xm, Ms, Ms, Ms, Ms, Ms, Ms, Ms, Ms, Ms, Ms, Ms, Ha, Ha^Fpa, Ha^Fpa, Ha, Gd, Gd, Aa, Aa, Gd, Aa, Aa^Fma, Ha^Fma, Ha, Ha, Ms^Xm, Ms^Xm, Ms^Xm, Ha, Ha^Fpa, Ha^Fpa, Ha, Ha, Ms, Ms, Ms, Ai, Ai, Ms, Ms^Xm, Ms, Ms^Xm, Ms^Xm, Ms, Ms, Ms, Ms^Xm, Ms^Xm, Ha^Fpa, Ha^Fpa
Ms, Ms^Xm, Ms^Xm, Ms^Xm, Ms^Xm, Ms^Xm, Ms^Xm, Ms^Xm, Ms, Ms, Ms, Ms, Ms, Ms, Ms, Ms, Ms, Aa, Ms^Xm, Ms, Ha, Ha, Ha, Ms, Ms, Ms, Ms, Ms, Ms, Ms, Ms, Ha, Ha, Ha^Fpa, Ha^Fpa, Gd, Aa, Aa, Aa, Gd, Aa, Ha, Ha^Vha, Ha^Fma, Ha, Ms^Xm, Ms^Xm, Ms, Ms^Xm, Ha, Ha^Fma, Ha^Fpa, Ha, Ms, Ai, Ai, Ms, Ms, Ms, Ms, Ms, Ms, Ms, Ms, Ms, Ms, Ms^Xm, Ha, Ha^Fpa, Ha^Fpa
Ms, Ms^Xm, Ms^Xm, Ms^Xm, Ms^Xm, Ms, Ms, Ms, Ms, Ha, Ms, Ms, Ms, Ms, Ha, Ha, Ms, Ms, Ha, Ms, Ms, Ha^Fpa, Ha^Fma, Ha, Ms, Ms, Ms, Ms, Ms^Xm, Ms, Ms, Ms, Ha, Ha^Fpa, Ai, Ha, Gd, Gd, Gd, Aa, Aa, Aa, Ha, Ha, Ha, Ms, Ms^Xm, Ms^Xm, Ms, Ha, Aa^Fpa, Ha, Ai, Ai, Ha, Ha^Vha, Aa, Ms, Ms, Ms, Ms, Ms, Ms, Ms, Ms, Ms, Ha, Aa, Ha^Fpa, Ha
Ms, Ms^Xm, Ms^Xm, Ms^Xm, Ha, Ms^Xm, Ms, Ms, Ha, Ms, Ms, Aa, Ms, Ha, Ms, Ms, Ha, Ha, Aa, Ms, Aa, Ha, Aa^Fma, Ha^Fma, Ha, Ms, Ha, Ms, Ha, Ha, Ha, Ha, Cea, Ai, 2 Kea, Cea, Cea, Gd, Aa, Aa, Aa, Ha, Aa, Aa, Ha, Ha, Ha, Ha, Ha, Ha^Fpa, Aa^Fpa, Ai, Ha, Ha^Fpa, Aa, Aa, Ha, Ha, Ha, Ha^Fpa, Ha^Fma, Ms, Ms, Ms, Ms, Ha, Ha^Fpa, Ha^Fpa, Aa^Fpa, Aa
Ms^Xm, Ms^Xm, Ms^Xm, Ms^Xm, Ms, Ms, Ms, Ha, Aa, Ms, Ms, Ha, Aa, Ms, Ha, Ha, Ha, Ha, Ms, Ms, Ms, Ms, Aa, Aa^Fpa, Ha^Fpa, Ha, Ha, Ha, Aa, Ha, Aa, Ha, Cea, Cea, Cea, Cea, Cea, Cea, Gd, Aa, Ai, Aa, Ha, Aa, Aa, Ha, Aa, Ha, Ha, Ms, Ai, Ww, Ha, Aa, Cea, Aa^Fma, Cea, Cea, Cea, Ha, Ha^Fpa, Ha^Fma, Ha^Fpa, Ms, Aa, Aa, Ha^Fma, Aa^Fma, Ha, Ha
Ms^Xm, Ms^Xm, Ms^Xm, Ms, Ms, Ha, Ms, Ha, Ms, Ha, Ms, Ha, Ms, Ha, Aa, Ms, Ha, Aa, Ms, Ms, Aa, Ms, Aa^Fpa, Ha, Ha, Ha^Fpa, Ha^Fma, Ha^Fma, Ha^Vha, Aa, Ha, Gd, Aa, Cea, Gd, Cea, Ss, Gd, Ha, Sm, Ss, Wwf, Ss, Ha, Ha, Aa, Aa, Aa, Aa, Ai, Ww, Ai, Cea, Cea, Cea, 3 Kea, Cea, Cea, Cea, Ha, Ha, Ha^Fma, Ha^Fma, Ha^Fma, Ha^Fpa, Ha^Fma, Ha^Fpa, Aa, Aa, Gd
Ms, Ms^Xm, Ms, Ms^Xm, Ms^Xm, Ms, Ms, Ms, Ms, Ms, Ha, Ms, Ha, Ms, Aa, Aa, Aa, Ms, Ms, Ms, Aa, Aa^Fma, Gd, Gd, Aa, Ha, Aa^Fpa, Ha^Fpa, Aa, Ss, Gd, Gd, Gd, Sm, Aa, Ai, Ha, Gd, Gd, Sm, Gd, Gd, Gd, Aa, Aa, Gd, Gd, Aa^Vha, Gd, Ai, Ww, Ai, Aa, Cea, Gd, Cea, Gd, Cea, Gd, Ha, Gd, Ha, Ha, Ha^Vha, Ha, Ha^Fpa, Aa, Aa, Gd, Gd
Ms, Ms, Ms, Ms, Ms, Ms, Ms, Ms, Ms, Ha, Ms, Ha, Ha, Ha, Ms, Ha, Aa, Ha, Ms, Ha, Aa^Fpa, Aa, Aa, Aa, Aa, Aa, Gd^Fp, Aa^Fma, Aa^Fma, Aa^Fma, Ss, Ai, Wwf, Ai, Sm, Ss, Ss, Ai, Sm, Ha, Ha^Fpa, Aa^Fpa, Sm, Gd, Gd, Gd, Ai, Gd, Gd, Gd, Aa, Aa, Gd, Gd, Aa, Gd, Aa, Gd, Aa, Aa, Gd, Ha, Ha, Ha, Ha, Aa, Aa, Aa, Gd, Gd
Ms, Ms^Xm, Ms^Xm, Ms, Ms, Ha, Ms, Ms, Ha, Ms, Ms, Ha, Ha, Aa, Ha, Aa, Ms, Ha, Ai, Ha, Aa, Aa^Fpa, Gd, Aa, Ww, Ww, Wo, Gd^Fp, Ww, Hhd, Aa, Aa^Fma, Wwf, Ai, Aa^Fpa, Gd^Fp, Sm, Sm, Aa, Ha, Aa^Fpa, Ha, Gd, Wwf, Ss, Aa, Sm, Ww, Sm, Gd, Gd, Aa, Gd, Aa, Aa, Ss, Sm, Aa, Gd, Aa, Gd, Gd, Gd, Aa, Aa, Gd, Ha, Ha, Aa, Ms
Ha, Ms^Xm, Ms^Xm, Ms, Ms, Ms, Ms, Ha, Ha, Ha, Ha, Ms, Aa, Ha, Aa, Ha, Aa, Aa, Ai, Aa, Ai, Aa, Aa, Ww, Wo, Ha, Ms, Wo, Ha^Fpa, Aa^Fma, Ms, Aa^Fma, Aa, Wwf, Gd, Aa, Gd^Fp, Gd^Fp, Gd, Aa, Sm, Ai, Wwf, Ai, Wwf, Sm, Aa, Sm, Sm, Aa, Sm, Sm, Wwf, Aa, Wwf, Wwf, Wwf, Sm, Aa, Gd, Aa, Gd, Aa^Fpa, Aa, Ha^Fma, Aa^Fma, Aa, Ha, Ha, Ha
Ms, Ms^Xm, Ms^Xm, Ha, Ms, Ha, Ms, Ms, Ha, Aa, Ha, Aa, Ha, Ha, Ha, Ha, Ha, Ha, Aa^Fpa, Aa^Fpa, Ai, Wwf, Wo, Wo, Aa, Aa, Ha, Ha, Ha^Fpa, Ms, Ms, Ms, Ha, Wwf, Wwf, Aa, Ss, Gd, Sm, Gd, Wwf, Gd, Aa, Wwf, Ai, Gd, Wwf, Gd, Sm, Sm, Ai, Aa, Ha, Aa, Ha^Fpa, Ai, Aa, Aa, Aa, Aa, Aa, Aa^Fma, Ha, Ha, Aa, Ha^Fma, Aa, Aa, Ha, Ha
Ms, Ms^Xm, Ms, Ha, Ms^Xm, Ms, Ha, Ha, Ms, Ha, Aa, Ha, Ms, Ha, Aa, Ha, Ha, Ha, Ai, Wwf, Ww, Ww, Aa, Ai, Ww, Ha, Wwf, Aa, Gd, Ha, Aa, Ms, Ms, Ai, Aa, Gd, Wwf, Sm, Gd, Gd, Ha^Fma, Ww, Ww, Aa, Ww, Ww, Aa, Wwf, Wwf, Wwf, Wwf, Ai, Gd, Ha, Gd^Fp, Aa^Fma, Aa^Fpa, Wwf, Gd, Gd, Gd, Aa, Gd, Gd, Cea, Ha, Cea, Ha, Ms, Ms
Ms, Ms, Ms, Ms^Xm, Ha, Ms, Ha, Aa, Ms, Ha, Aa, Ms, Ms, Aa, Ha, Ha, Aa, Aa, Ai, Ai, Wwf, Aa, Ww, Wo, Sm, Ai, Aa, Wwf, Wwf, Gd, Aa^Voa, Ha, Ms, Ms, Ss, Gd, Sm, Wwf, Ai, Ai, Aa^Fma, Aa, Ai, Ww, Aa^Fma, Ww, Ha, Gd, Ai, Wwf, Sm, Wwf, Wwf, Gd, Gd, Wwf, Gd, Gd, Gd, Ha^Vha, Aa, Gd, Cea, Cea, 4 Kea, Cea, Cea, Ha, Ms^Xm, Ms^Xm
Ms, Ms, Ms^Xm, Ha, Ms, Ms, Ms, Ha, Aa, Ms, Ms, Ms, Aa, Aa, Ha, Ha, Aa, Aa, Ai, Aa, Aa, Ww, Wo, Sm, Ha, Gd^Fp, Ai, Ai, Ss, Gd, Gd, Gd, Ha, Ha, Ms, Sm, Aa, Aa, Sm, Ss, Gd, Gd^Vhr, Wwf, Aa, Gd, Ha, Gd, Gd^Fp, Aa, Aa^Fma, Gd^Fp, Gd, Wwf, Ss, Ai, Ss, Ai, Gd, Ai, Ha, Ha^Fpa, Aa, Cea, Cea, Cea, Cea, Ms, Ms, Ms, Ms^Xm
Ms^Xm, Ms, Ha, Ha, Ha, Ha, Ha, Ms, Aa, Ms, Aa, Ms, Ms, Aa, Ha, Aa, Aa, Ha, Ww, Aa, Ai, Ai, Wo, Aa, Ww, Ha, Wwf, Ss, Ss, Sm, Sm, Gd, Sm, Sm, Aa^Fpa, Aa^Fpa, Aa^Fpa, Aa, Ww, Wwf, Ai, Ai, Ss, Wwf, Sm, Gd, Gd, Aa, Wwf, Gd, Gd, Aa^Fma, Gd, Ss, Wwf, Ai, Gd, Ww, Ai, Ha, Ha, Ha, Ha^Fpa, Ha, Ms, Ms, Ms, Ms, Ms, Ms^Xm
Ha, Ms^Xm, Ha, Ms, Ha, Ms, Ha, Ms, Ha, Ms, Ms, Aa, Aa, Wwf, Aa, Aa, Ha, Aa, Ww, Aa, Ai, Wo, Wo, Ww, Wwf, Ww, Gd, Gd^Fp, Gd^Fp, Sm, Gd, Wwf, Sm, Aa^Fpa, Sm, Ha, Ww, Sm, Aa^Fpa, Wwf, Ai, Ww, Ai, Sm, Ss, Sm, Sm, Wwf, Ha^Fma, Ai, Aa^Fma, Gd, Aa, Aa, Ai, Ai, Ai, Ai, Ai, Ha, Ai, Ha^Fpa, Aa, Ha, Ha, Ms, Ms, Ms, Ms, Ms^Xm
Ha, Ha, Ha, Ha, Ha, Ha, Ms, Ha, Aa, Ms, Ms, Aa, Wwf, Aa, Aa, Ha, Ww, Ww, Ai, Ww, Ai, Ww, Ai, Ai, Ai, Wwf, Gd^Fp, Ha^Fpa, Wwf, Ai, Gd, Ha, Ha^Fpa, Aa, Ss, Ha, Aa^Voa, Gd, Ha, Ha, Aa, Ms, Aa^Voa, Sm, Ai, Ai, Ww, Ww, Wwf, Ww, Aa, Ai, Ww, Gd^Vhr, Ww, Aa, Ai, Ai, Aa^Fpa, Ai, Aa^Fpa, Ha^Fpa, Ha^Fpa, Aa, Aa, Ha, Ha, Ms, Ms, Ms^Xm
Aa, Ha, Aa, Ms, Ha, Ms, Ha, Ha, Ha, Ha, Ai, Wwf, Aa, Aa, Wwf, Ai, Wo, Wo, Ww, Ww, Wwf, Ww, Wwf, Ai, Wwf, Wwf, Aa, Ai, Wwf, Wwf, Aa, Gd, Hhd, Ss, Aa, Aa, Hhd, Hhd, Coa, Coa, Ha, Hhd, Ha, Gd, Ww, Aa^Fpa, Wo, Ai, Wo, Wo, Wo, Ai, Wo, Wwf, Aa, Aa, Wo, Ww, Ww, Ai, Ai, Aa, Aa^Fpa, Ha, Ha^Fpa, Aa, Ha, Ms, Ms, Ms
Ha, Aa, Aa, Aa, Aa, Ha, Ha, Ha, Ha, Aa, Ai, Ai, Wwf, Aa, Ww, Ai, Wwf, Wwf, Ai, Wwf, Aa, Ai, Aa, Wwf, Aa, Wwf, Wwf, Gd, Aa, Gd, Gd, Aa^Vha, Aa, Ha, Ms, Ai, Hhd, Ha, Coa, Coa, Coa, Coa, Hhd, Gd, Gd, Ai, Ss, Wo, Wwf, Aa, Ww, Wwf, Aa^Fma, Wo, Wo, Wo, Wwf, Aa, Wo, Ha, Ai, Ha, Ha, Aa^Fpa, Ha^Fpa, Ha, Ha, Ha, Ha, Ms
Aa, Ha, Aa, Gd, Aa, Ha, Aa, Aa, Aa, Ha, Ai, Ww, Aa, Ai, Wwf, Ai, Wwf, Ai, Wwf, Ai, Wwf, Wwf, Aa, Aa, Hhd, Aa^Fma, Hhd, Wwf, Wwf, Aa, Aa, Aa^Fpa, Ha^Fpa, Ha, Aa, Gd, Ha, Coa, Coa, 1 Koa, Coa, Coa, Hhd, Ss, Wwf, Wwf, Wwf, Ww, Gd, Ai, Ai, Ww, Ww, Ww, Wwf, Ww, Ww, Wwf, Aa^Fma, Ai, Ww, Ww, Ww, Aa, Aa, Ai, Ha^Fpa, Ha, Ha, Ha
Aa, Aa, Aa, Gd, Gd, Aa, Aa, Ha, Ha, Aa, Aa, Wwf, Wo, Ai, Ai, Ww, Wwf, Wwf, Wwf, Wwf, Aa, Aa, Wwf, Hhd, Wwf, Gd^Fp, Aa, Gd, Hhd, Aa, Ha^Fpa, Wwf, Aa, Gd, Gd, Aa, Hhd, Coa, Ms^Xm, Coa, Coa, Hhd, Hhd, Hhd, Gd, Wwf, Ww, Aa, Aa^Fpa, Ww, Ha^Fma, Ww, Ai, Ai, Ww, Ai, Ww, Ai, Ai, Ai, Ww, Aa^Fma, Wo, Ww, Ww, Wwf, Ww, Ai, Ha, Ai
Aa, Gd, Gd, Gd, Aa, Aa, Aa, Aa, Ha, Ha, Aa^Bw\r, Gd^Bw\r, Aa^Bw\r, Wo, Ai, Wwf, Aa, Aa, Gd, Ha, Aa, Ha^Vha, Aa, Wwf, Ss, Ss, Gd^Fp, Ss, Hhd, Ww, Aa, Aa, Gd, Sm, Ss, Aa^Fpa, Gd, Ha, Ha, Coa, Hhd, Ha, Aa, Hhd, Aa, Gd, Aa, Aa^Fpa, Aa^Fpa, Gd, Ww, Ss, Ww, Aa^Fpa, Ha^Fpa, Ww, Ai, Ai, Ai, Gd, Wwf, Ww, Ww, Ai, Wo, Ww, Ww, Ai, Ww, Ai
Gd, Aa, Gd, Aa, Aa, Aa, Aa, Gd, Aa, Aa, Wwf, Aa^Bw\r, Wo^Bw\r, Ww^Bw\r, Ww^Bw\r, Wwf, Aa, Gd, Gd, Aa, Ha, Gd, Ss, Ha, Ss, Aa, Aa, Ss, Aa^Voa, Aa, Ai, Gd, Ss, Ss, Aa, Sm, Aa^Fpa, Aa, Ha, Aa, Hhd, Ha, Wwf, Aa^Voa, Aa, Gd, Gd, Aa, Aa, Gd, Ww, Ai, Ai, Aa^Fpa, Aa^Fpa, Ai, Aa^Fpa, Gd, Gd, Aa, Aa, Ww, Ai, Ww, Ww, Wo, Wo, Ww, Wo, Wwf
Aa, Gd, Aa, Aa, Aa, Aa, Aa, Aa, Wwf, Aa, Wwf, Aa, Ww, Aa^Bw\r, Wwf^Bw\r, Gd, Aa^Fpa, Aa, Gd, Wwf, Ms, Ha, Ai, Ss, Sm, Gd^Fp, Aa, Gd, Aa^Fma, Aa, Aa, Aa, Wwf, Ss, Ss, Aa, Ha^Fpa, Gd, Aa^Fpa, Ms, Aa, Gd, Sm, Aa, Ww, Aa, Ww, Ww, Aa, Gd^Vhr, Gd, Gd, Ai, Aa, Ai, Aa, Aa^Fpa, Aa^Fpa, Gd, Aa, Ai, Ai, Ai, Wwf, Ai, Ww, Ai, Wo, Ww, Wo
Aa, Aa, Aa, Gd, Aa, Aa, Aa, Aa, Ai, Wwf, Wo, Wo, Ww, Ai, Aa, Aa^Fpa, Ha^Fpa, Gd^Fp, Aa, Wwf, Wwf, Aa, Aa, Sm, Wwf, Gd^Fp, Aa^Fma, Aa, Gd^Fp, Aa, Gd, Wwf, Aa, Ha, Ss, Ss, Ha, Aa^Voa, Gd, Ww, Sm, Wwf, Ww, Ww, Aa, Ss, Ss, Wwf, Sm, Gd, Gd, Ai, Aa, Ai, Gd, Aa, Gd, Wwf, Chr, Gd, Chr, Ha, Ha^Vha, Ai, Ai, Ha^Fpa, Ai, Ha^Fpa, Ha^Fpa, Ai
Gd, Aa, Gd, Gd, Ai, Aa, Ai, Ai, Wwf, Wo, Ai, Ai, Aa, Ai, Ww, Aa, Gd^Fp, Ha^Fpa, Ha^Fpa, Gd, Ha^Fpa, Gd, Gd, Aa, Wwf, Aa, Aa^Fma, Aa, Gd^Fp, Gd, Wwf, Wwf, Aa, Ss, Aa^Fma, Ss, Ss, Ss, Gd^Fp, Gd, Ha^Fpa, Ww, Ww, Ww, Aa, Gd, Ww, Wwf, Ss, Ss, Aa, Ai, Aa^Fpa, Aa^Fpa, Gd^Fp, Gd, Aa^Fpa, Chr, Chr, Chr, Chr, Ai, Ha, Ha, Ha, Ai, Ai, Ha, Ha, Ha
Wwf, Aa, Aa, Ai, Wwf, Ai, Wwf, Wwf, Wo, Wo, Ai, Aa, Ai, Aa, Aa, Aa, Aa^Fma, Ha, Sm, Ha, Ha^Fpa, Aa, Gd, Gd^Vo, Aa, Wwf, Aa, Aa^Fma, Aa, Sm, Ai, Ai, Aa, Ha^Fpa, Ha^Fpa, Ha^Fpa, Ha^Fma, Gd^Fp, Gd^Fp, Gd^Fp, Ha, Ha^Fpa, Aa, Aa, Aa, Ww, Ww, Aa, Aa, Ss, Sm, Aa, Aa, Aa^Fpa, Aa^Fpa, Aa^Fpa, Aa^Fpa, Chr, Chr, 7 Khr, Chr, Ha, Ms, Ha, Ms, Ms, Ai, Ha, Ms, Ms
Aa, Aa, Wwf, Aa, Ww, Ai, Wwf, Wwf, Wo, Aa, Ai, Aa, Ww, Ww, Aa, Ss, Ss, Sm, Ss, Aa, Ss, Ha^Fpa, Gd, Gd, Gd, Wwf, Wwf, Aa, Aa, Wwf, Sm, Aa, Aa, Aa, Ss, Aa, Aa^Fpa, Gd^Fp, Aa^Fma, Ha^Fma, Ww, Ha^Fpa, Ss, Ww, Ww, Gd, Gd, Ww, Ww, Ss, Wwf, Aa, Gd, Wwf, Gd, Aa, Gd, Chr, Ha, Chr, Ha, Ha, Ms, Ms, Ms^Xm, Ms^Xm, Ms^Xm, Ms^Xm, Ms^Xm, Ms^Xm
Aa, Wwf, Ww, Wwf, Wo, Wo, Ai, Wwf, Ai, Ai, Ai, Ai, Aa, Ai, Aa, Aa, Aa^Fpa, Sm, Gd, Ss, Aa^Fpa, Gd^Fp, Gd, Gd, Aa^Fma, Aa, Ha^Fma, Wwf, Wwf, Wwf, Gd, Sm, Ai, Aa^Fma, Ai, Sm, Aa^Fpa, Aa^Fpa, Ww, Aa, Sm, Ww, Gd, Gd, Aa, Gd^Vhr, Aa, Ww, Ai, Sm, Ss, Wwf, Gd, Ai, Ss, Gd, Ha, Ha, Ha^Fma, Ha^Fma, Ms, Ms, Ms, Ms, Ms^Xm, Ms^Xm, Ms^Xm, Ms^Xm, Ms^Xm, Ms^Xm
Aa, Aa, Wwf, Ww, Wo, Wo, Aa, Ai, Ai, Ww, Aa, Ww, Ms, Aa, Aa^Fpa, Aa^Fpa, Gd, Aa, Aa, Wwf, Wwf, Gd, Gd, Aa, Ha^Fma, Ha^Fpa, Ha^Fma, Wwf, Ha, Gd, Ha, Gd, Sm, Wwf, Wwf, Ss, Ss, Gd, Sm, Ww, Ww, Aa, Aa, Ww, Aa, Ha, Aa, Ss, Gd^Fp, Ai, Gd, Wwf, Ss, Ss, Gd, Gd, Ha, Ha^Fma, Aa^Vha, Ha, Ms, Ms, Ms^Xm, Ms^Xm, Ms^Xm, Ms^Xm, Ms^Xm, Ms^Xm, Ms^Xm, Ms^Xm
Ww, Ww, Wo, Wo, Wo, Ai, Ai, Aa, Ai, Ha, Ms, Aa, Ms, Aa, Aa^Fpa, Aa, Gd, Aa, Aa, Aa, Ha, Ha, Gd, Aa, Chr, Ha^Fma, Wwf, Wwf, Ai, Ha, Ha, Gd, Gd, Wwf, Wwf, Ss, Sm, Aa, Wwf, Sm, Sm, Aa, Aa, Ha, Ha, Ha^Fma, Aa^Fma, Gd^Fp, Gd, Gd, Aa, Aa, Gd, Gd, Ha, Ha, Ha^Fpa, Ha^Fma, Aa^Fpa, Ha, Ha, Ms^Xm, Ms, Ms^Xm, Ms^Xm, Ms^Xm, Ms^Xm, Ms^Xm, Ms^Xm, Ms^Xm
Ww, Aa, Aa, Wo, Aa, Aa, Ms, Ms^Xm, Ha, Ha, Ha^Fma, Ha^Fma, Ha^Fma, Aa^Fpa, Ms, Aa, Aa, Aa, Ha, Ha^Fma, Ha, Ha, Gd, Chr, Chw, Chw, 5 Khw, Chw, Chw, Chr, Ha, Ha, Gd^Fp, Gd, Gd, Gd, Wwf, Wwf, Sm, Wwf, Gd, Wwf, Wwf, Gd, Aa^Fma, Aa^Fma, Gd, Gd, Gd, Gd, Gd, Aa, Gd, Aa, Aa, Ha^Fpa, Ha, Ha, Aa^Fpa, Ha^Fpa, Ha, Ms, Ms, Ms, Ms^Xm, Ms^Xm, Ms^Xm, Ms^Xm, Ms^Xm, Ms^Xm
Aa, Wwf, Wo, Wo, Aa, Ms, Ms^Xm, Aa, Ha, Aa, Ha, Aa, Ha^Fma, Ha^Fma, Aa, Ms^Xm, Aa, Aa, Aa^Fma, Ha^Fma, Aa, Aa^Voa, Aa, Wwf, Wwf, Chw, Wwf, Chw, Ai, Chr, Aa^Fpa, Gd^Fp, Aa^Fpa, Gd, Aa, Gd, Aa, Ai, Sm, Aa, Aa, Sm, Gd, Gd, Gd, Gd, Aa, Aa, Chr, Gd, Chr, Gd, Gd^Fp, Gd, Aa, Ha, Ha, Ha, Ha^Fma, Ha, Ha, Ms, Ms, Ms, Ms, Ms^Xm, Ms^Xm, Ms^Xm, Ms^Xm, Ms^Xm
Wwf, Wo, Ai, Aa, Ms, Ms, Aa, Ms^Xm, Ms^Xm, Ha^Fma, Ha, Ha^Fma, Ha^Fma, Ha^Fma, Ms^Xm, Ms^Xm, Ms^Xm, Aa, Ms^Xm, Aa, Gd, Aa, Aa, Aa, Gd, Wwf, Wwf, Wwf, Aa^Fpa, Aa^Fpa, Aa, Aa^Fpa, Aa^Fpa, Aa, Ha, Ha, Ha, Ha, Ha, Aa, Ha^Voa, Aa, Sm, Gd, Gd, Chr, Chr, Chr, 6 Khr, Chr, Chr, Chr, Chr, Gd^Fp, Gd, Aa, Aa, Ha, Ha^Fpa, Ha, Ms, Ms, Ms, Ms, Ms, Ms, Ms, Ms^Xm, Ms, Ms^Xm
Wo, Aa, Ms, Ms, Ms^Xm, Ms^Xm, Ms^Xm, Ms^Xm, Ha^Fma, Ha^Fma, Aa, Ha, Ha^Fma, Ms, Ms, Ms^Xm, Ms^Xm, Ms^Xm, Ms^Xm, Ms^Xm, Aa, Aa, Ha, Gd, Aa, Wwf, Ww, Ai, Ai, Aa^Fpa, Gd, Aa, Aa, Ha, Aa, Aa, Ha^Fpa, Ha, Aa, Aa, Aa, Aa, Ai, Wwf, Aa^Fma, Chr, Gd, Chr, Aa, Chr, Aa, Chr, Gd, Gd^Fp, Aa, Aa, Ha, Ha, Aa, Ha, Ha^Fpa, Ai, Ms, Ms, Ms, Ms, Ms, Ms, Ms, Ms
Ai, Ai, Ms^Xm, Ms, Ms^Xm, Ms, Ms, Ha^Fma, Ha^Fma, Ha^Fma, Ha, Ha^Fma, Ha^Fma, Ms^Xm, Ms, Ms^Xm, Ms^Xm, Ms^Xm, Ha, Ha, Ha^Fpa, Ha^Fpa, Ha, Ha, Aa, Aa, Ai, Ww, Ai, Aa, Ha^Voa, Ha, Ha, Aa, Ha^Fpa, Ha^Fpa, Ha^Fpa, Ha, Ha, Ha^Fma, Ha^Fpa, Ha, Ha, Ai, Aa^Fma, Aa^Fma, Gd, Aa, Aa, Gd, Aa, Aa, Gd, Aa, Ha, Aa, Ha, Aa, Ha, Aa, Aa^Fpa, Ai, Ai, Ms, Ms, Ms, Ms, Ms, Ms, Ms
Ww, Ms, Ms^Xm, Ms^Xm, Ms^Xm, Ms^Xm, Ms, Ha^Fma, Ha^Fma, Ha, Ha^Fma, Ha^Fma, Ms, Ms, Ms^Xm, Ms, Ms^Xm, Ms^Xm, Ha^Fpa, Ha^Fpa, Ha^Fma, Ha^Fpa, Ha^Fpa, Aa, Ha^Fma, Ha, Gd, Ww, Gd, Aa, Ha^Fpa, Aa^Fma, Ha^Fma, Ha^Fma, Ha, Ha^Fma, Ms, Ms, Ms, Ha, Ha^Fma, Ha^Fma, Ha, Aa, Gd^Fp, Aa^Fma, Gd^Fp, Aa, Aa, Aa, Gd, Gd, Aa, Aa, Ha, Ha, Ha, Ha, Ha, Ha^Vha, Ha, Aa^Fpa, Ha, Ai, Ms, Ms, Ms, Ms, Ms, Ms
Wwf, Ms, Ms^Xm, Ms, Ms, Ms, Ms^Xm, Ha^Fma, Ha^Fma, Aa, Ha^Fma, Ms, Ms, Ms, Ms^Xm, Ms^Xm, Ms^Xm, Ms^Fpa, Ms^Fpa, Ha^Fpa, Ha, Ha^Fpa, Ms, Ha, Ha^Fma, Ha, Aa, Ww, Ha, Ha^Fpa, Ha, Aa^Fpa, Ms, Ha, Ms, Ms, Ms, Ms, Ms, Ha, Ha^Fma, Ha, Ha, Aa, Aa, Aa^Fpa, Aa^Fpa, Aa, Aa, Gd^Vhr, Gd, Gd, Ha, Ha, Ha^Fma, Ha, Ms, Ms, Ms, Ha, Ms, Ha^Fpa, Ha, Ai, Ms, Ms, Ms, Ms, Ms^Xm, Aa
Ms^Xm, Ms^Xm, Ms^Xm, Ms^Xm, Ms, Ms, Ha^Fma, Ha^Fma, Ha, Ha^Fma, Ha^Fma, Ms, Ms^Xm, Ms^Xm, Ai, Ms^Xm, Ms^Xm, Ms^Fpa, Ms^Xm, Ms^Xm, Ms, Ms, Ms, Ha, Ha, Ha^Fpa, Ww, Ww, Ha, Ha^Fpa, Ha, Ms, Ms, Ms, Ms^Xm, Ms^Xm, Ms^Xm, Ms^Xm, Ms^Xm, Ha, Ha^Fpa, Ha^Fpa, Aa, Aa, Gd, Aa^Fpa, Aa^Fma, Aa^Fpa, Aa^Fpa, Aa^Fpa, Gd, Aa, Ha^Fma, Ha^Fma, Ha, Ha, Ms, Ms, Ms, Ms, Ms, Ms, Ms, Ai, Ai, Ms, Ms, Ms^Xm, Ms^Xm, Ms^Xm
Ms^Xm, Ms^Xm, Ms^Xm, Ms^Xm, Ms^Xm, Ms, Ha^Fma, Aa, Ha^Fma, Ha^Fma, Ms, Ms, Ms^Xm, Ai, Ai, Ai, Ms^Xm, Ms^Xm, Ms^Xm, Ms^Xm, Ms, Ms, Ms, Ms, Ms, Ai, Ww, Ai, Aa, Ha^Fpa, Ha, Ms, Ms, Ms, Ms^Xm, Ms^Xm, Ms^Xm, Ms^Xm, Ms^Xm, Ms, Ms, Ha^Fpa, Ha, Aa, Aa, Aa^Fpa, Aa^Fpa, Aa^Fpa, Gd, Aa, Aa, Ha, Ha, Ha, Ha, Ha, Ms, Ms, Ms^Xm, Ms, Ms, Ms, Ms, Ms, Ms, Ai, Ai, Ms^Xm, Ms^Xm, Ms^Xm
Ms^Xm, Ms^Xm, Ms^Xm, Ms, Ms, Ms, Ha^Fma, Aa, Aa, Ha, Ha, Ms, Ms, Ms^Xm, Ms^Xm, Ms^Xm, Ms^Xm, Ms^Xm, Ms^Xm, Ms^Xm, Ms, Ms, Ms, Ms, Ms, Ms, Ai, Ww, Ai, Ha, Ha, Ms, Ms, Ms, Ms^Xm, Ms^Xm, Ms^Xm, Ms^Xm, Ms^Xm, Ms, Ms, Ms, Ha, Ha, Aa, Aa^Fpa, Aa, Aa^Fpa, Gd, Gd, Aa, Ha, Ha, Ha, Ms, Ms^Xm, Ms^Xm, Ms^Xm, Ms^Xm, Ms^Xm, Ms^Xm, Ms^Xm, Ms^Xm, Ms, Ms^Xm, Ms^Xm, Ms^Xm, Ms^Xm, Ms^Xm, Ms^Xm
Ms^Xm, Ms, Aa, Ms, Ms, Ms, Ms, Ha^Fma, Aa, Ha, Ha, Ms, Ms, Ms^Xm, Ms^Xm, Ms^Xm, Ms^Xm, Ms^Xm, Ms^Xm, Ms^Xm, Ms, Ms, Ms, Ms, Ms, Ai, Ai, Ww, Aa, Ha, Ms, Ms, Ms, Ms, Ms^Xm, Ms^Xm, Ms^Xm, Ms^Xm, Ms^Xm, Ms^Xm, Ms^Xm, Ms^Xm, Ms^Xm, Ha, Gd, Aa, Aa, Aa, Gd, Aa, Aa, Ai, Ms, Ms, Ms, Ms^Xm, Ms^Xm, Ms^Xm, Ms^Xm, Ms^Xm, Ms^Xm, Ms^Xm, Ms^Xm, Ms^Xm, Ms^Xm, Ms^Xm, Ms^Xm, Ms^Xm, Ms^Xm, Ms^Xm
