border_size=1
usage=map

Ms^Xm, Ms^Xm, Ms^Xm, Ha^Fpa, Ms^Xm, Rb, Ms^Xm, Ms, Ms, Ms^Xm, Ms, Ms, Ms, Ms, Ms, Ms^Xm, Ms, Ms^Xm, Ms, Ms, Ms, Ms, Ms^Xm, Aa, Ha, Ha, Wog, Wog, Mm, Wog, Mm, Wog, Mm, Mm^Xm, Mm^Xm, Mm, Ms^Xm, Mm^Xm, Ms^Xm, Ms^Xm, Ms^Xm, Re, Ms^Xm, Mm^Xm, Ms^Xm, Mm, Ms^Xm, Ms^Xm, Ms, Mm^Xm, Mm^Xm, Wog
Ms^Xm, Ms^Xm, Ms^Xm, Ms^Xm, Ms^Xm, Ms^Xm, Ms^Xm, Ms^Xm, Ms^Xm, Ms^Xm, Ms^Xm, Ms^Xm, Ms, Ms^Xm, Ms^Xm, Ms^Xm, Ms^Xm, Ms^Xm, Ms^Xm, Ms^Xm, Ms^Xm, Ms, Ms^Xm, Ha, Ms^Xm, Ms^Xm, Mm^Xm, Mm, Mm, Ms, Mm^Xm, Wog, Mm^Xm, Mm, Mm, Mm^Xm, Mm^Xm, Ms^Xm, Ms^Xm, Ms^Xm, Ms^Xm, Ms^Xm, Ms^Xm, Ms^Xm, Ms^Xm, Mm^Xm, Ms^Xm, Ms, Ms^Xm, Mm^Xm, Mm^Xm, Mm^Xm
Ms^Xm, Ms^Xm, Ms^Xm, Ms^Xm, Ms^Xm, Ms^Xm, Ms^Xm, Ms^Xm, Ms^Xm, Ms, Ms^Xm, Ms, Ms, Ms, Ms^Xm, Ms, Ha, Ms, Ms^Xm, Ms, Ms, Ms^Xm, Ms, Ms^Xm, Ha, Ha, Wog, Mm, Mm, Mm^Xm, Mm, Wog, Mm^Xm, Ms^Xm, Mm^Xm, Mm^Xm, Ms^Xm, Ms^Xm, Ms^Xm, Ms^Xm, Ms^Xm, Ms^Xm, Ms^Xm, Ms^Xm, Ms^Xm, Ms^Xm, Ms^Xm, Ms^Xm, Ms^Xm, Ms, Ms^Xm, Mm^Xm
Ms^Xm, Ms^Xm, Ms^Xm, Ms^Xm, Ms^Xm, Ms^Xm, Ms^Xm, Ms^Xm, Ms^Xm, Ms^Xm, Ms, Ms^Xm, Ms, Ms^Xm, Ms^Xm, Ms^Xm, Ms^Xm, Ms^Xm, Ha, Ms^Xm, Ha, Ms^Xm, Ms^Xm, Ms^Xm, Ms^Xm, Ms^Xm, Mm^Xm, Mm, Mm^Xm, Wog, Wog, Wog, Mm, Mm^Xm, Ms^Xm, Mm, Ms^Xm, Ms^Xm, Ms^Xm, Ms^Xm, Ms^Xm, Ms^Xm, Ms^Xm, Ms^Xm, Ms^Xm, Ms^Xm, Ms^Xm, Ms^Xm, Ms^Xm, Ms^Xm, Mm^Xm, Mm
Ms^Xm, Ms^Xm, Ms, Ms^Xm, Ms^Xm, Ms, Ms^Xm, Ms, Ms^Xm, Ms^Xm, Ms^Xm, Ms, Ms, Ha, Ms^Xm, Ms^Xm, Ha, Ha, Ms^Xm, Ms, Ms, Ms, Ha, Ms, Ms, Ms, Ms, Ms, Mm^Xm, Mm^Xm, Mm, Wog, Mm^Xm, Mm^Xm, Wog, Ms, Ms, Ms^Xm, Ms^Xm, Ms^Xm, Ms^Xm, Ms, Ms^Xm, Ms, Ms^Xm, Ms, Ms^Xm, Ms^Xm, Ms^Xm, Ms^Xm, Ms^Xm, Mm^Xm
Ms, Ms^Xm, Ms^Xm, Ms^Xm, Ms^Xm, Ms^Xm, Ms, Ms^Xm, Ms, Ms^Xm, Ha, Ha, Ha, Ms^Xm, Ha, Ms^Xm, Ha, Ms^Xm, Aa, Ha, Ms^Xm, Ha, Ms, Ms, Ha, Qxu, Qxu, Ms, Mm^Xm, Mm^Xm, Wog, Wog, Mm^Xm, Ms^Xm, Ms^Xm, Ms, Ms^Xm, Ms^Xm, Ms^Xm, Ms^Xm, Ms^Xm, Ms^Xm, Ms, Ms^Xm, Mm, Mm^Xm, Mm^Xm, Ms^Xm, Ms^Xm, Mm^Xm, Ms, Mm^Xm
Ms^Xm, Ms, Ms^Xm, Ms^Xm, Ms^Xm, Ms^Xm, Ms^Xm, Ms^Xm, Ha^Fda, Ms^Xm, Ha, Ha, Ms^Xm, Ha^Fda, Aa^Fda, Ha, Aa, Ms, Aa, Ha, Aa, Ha^Fda, Ha, Ms, Ha, Ms, Qxu, Ms, Mm^Xm, Wog, Wog, Wog, Mm, Mm^Xm, Ms, Ms, Ms, Ms, Ms^Xm, Ms^Xm, Ms^Xm, Ms^Xm, Ms^Xm, Ms^Xm, Ms^Xm, Mm^Xm, Mm^Xm, Mm, Mm, Mm^Xm, Mm^Xm, Mm^Xm
Ms^Xm, Ms^Xm, Ms^Xm, Ms^Xm, Ms^Xm, Ms^Xm, Ha, Ms, Ha^Fda, Ha, Aa, Ms^Xm, Ha, Aa, Ha^Fda, Aa^Fda, Aa, Aa, Re, Aa, Ha^Fda, Aa^Fda, Aa, Ha, Aa, Qxu, Ms, Mm^Xm, Mm, Mm^Xm, Wog, Mm^Xm, Mm^Xm, Ms, Ms, Ms, Ms, Ms, Ms, Ms, Ms^Xm, Ms, Ms^Xm, Ms, Ms, Ms, Wog, Ms, Ms^Xm, Ms, Mm^Xm, Mm^Xm
Ms^Xm, Ms^Xm, Ms^Xm, Ms^Xm, Ms^Xm, Ms^Xm, Ha, Ha, Ha, Aa^Fda, Aa^Fda, Aa, Ha, Aa, Aa, Aa^Fda, Rb, Ha, Rb, Aa, Aa^Fda, Aa, Aa, Ms^Xm, Qxu, Qxu, Ha, Mm, Sm, Wog, Wog, Mm, Mm^Xm, Ms^Xm, Ms, Ms, Ha, Ms, Ha, Ms, Ms, Ms, Ms, Ms, Ms, Ms, Wog, Mm^Xm, Ms^Xm, Mm^Xm, Ms, Mm^Xm
Ms^Xm, Ms^Xm, Ms^Xm, Ms^Xm, Ms, Ha, Ms^Xm, Aa, Aa, Aa^Fda, Aa, Aa^Fda, Uh, Rb, Hhd^Fdw, Re, Hhd^Fdw, Hhd^Fdw, Rb^Fdw, Rb, Aa^Fda, Aa^Fda, Aa, Aa, Qxu, Mm, Mm^Xm, Sm, Mm, Wog, Sm, Mm^Xm, Ms^Xm, Ms, Ms, Ha, Ms, Ha, Ha, Ms, Ha, Ms, Ms, Ms, Ms, Ms, Mm^Xm, Mm, Ms, Mm^Xm, Mm, Wog
Ms, Mm, Ms^Xm, Ha, Ha, Ms, Ms^Xm, Aa^Fda, Aa, Re, Rb^Fdw, Rb, Qxu, Hhd^Fdw, Sm, Rb, Rb, Rb^Fdw, Rb, Re, Qxu, Rb, Qxu, Qxu, Qxu, Mm^Xm, Mm^Xm, Ms, Wog, Wog, Mm^Xm, Ms^Xm, Ms, Ms, Ha^Fda, Ha^Fda, Ha^Fda, Ha^Fda, Aa, Ha^Fda, Aa, Ha, Ha, Ms, Ms, Mm, Mm^Xm, Ms^Xm, Ms, Ms, Wog, Mm^Xm
Ms, Ms, Ms, Ms, Ha, Ms^Xm, Ms^Xm, Ms^Xm, Ha, Hhd^Fdw, Hhd^Fdw, Uh, Qxu, Qxu, Re^Es, Qxu, Qxu, Aa, Uh, Uh, Qxu, Qxu, Rb, Qxu, Qxu, Mm, Rb, Wog, Wog, Wog, Wog, Wog, Mm, Ha, Ha, Ha, Ha^Fda, Aa, Ha, Aa^Fda, Aa, Ms, Aa, Ms, Ms, Ms, Ms, Mm^Xm, Mm^Xm, Mm^Xm, Mm^Xm, Wog
Mm^Xm, Ha^Fpa, Ms, Ha, Ms, Aa^Fda, Aa, Aa, Rb, Rb, Hhd^Fdw, Hhd^Fdw, Hhd^Fdw, Sm, Hhd^Fdw, Rb, Rb^Fdw, Qxu, Qxu, Qxu, Rb, Hhd, Rb, Qxu, Rb^Fdw, Rb^Edt, Sm, Wog, Wog, Wwg, Ms, Mm, Ms, Aa, Aa, Aa, Aa^Fda, Aa, Rb, Aa, Rb, Aa, Aa^Fda, Ms, Aa, Ms, Ha, Ms^Xm, Ms^Xm, Mm^Xm, Ms, Ms
Mm^Xm, Ms, Ms^Xm, Ms, Ha^Fpa, Aa^Fda, Aa^Fda, Re, Uh, Uh, Qxu, Rb^Fdw, Rb, Rb^Fdw, Rb^Fdw, Rb^Fdw, Sm, Rb^Fdw, Re, Rb, Rb^Fdw, Hhd, Rb, Sm^Dr, Sm, Rb^Dr, Sm, Wog, Wog, Sm, Rb, Ms, Mm, Re, Rb, Aa^Fda, Hhd^Fdw, Aa, Aa^Fda, Rb^Fdw, Rb^Fdw, Aa^Fda, Aa^Fda, Aa, Wog, Aa, Wog, Ha, Ms, Ms, Ms^Xm, Ms^Xm
Wog, Wog, Ms^Xm, Ms, Mm, Aa, Aa, Re, Uh, Qxu, Rb^Vhr, Qxu, Qxu, Qxu, Sm, Qxu, Qxu, Qxu, Rb, Rb, Sm, Sm, Rb^Fdw, Rb^Fdw, Uh, Sm, Wog, Wog, Wog, Wog, Rb^Es, Rb^Vhr, Rb^Fdw, Re, Qxu, Rb, Sm^Dr, Rb^Fdw, Aa^Fda, Rb, Qxu, Aa, Rb, Wwg, Rb, Aa, Aa, Ha^Fda, Ha^Fda, Ms^Xm, Ms, Mm^Xm
Ms^Xm, Wog, Wwg, Ms^Xm, Mm, Rb, Rb, Rb, Rb^Fdw, Rb^Fdw, Hhd^Fdw, Rb, Hhd^Fdw, Rb^Fdw, Rb, Qxu, Qxu, Hhd, Hhd, Rb^Fdw, Chr, Rb, Rb^Fdw, Qxu, Qxu, Rb^Fdw, Wog, Wog, Wog, Sm, Sm, Hhd, Hhd, Uh, Qxu, Rb, Sm, Hhd^Fdw, Aa, Aa, Qxu, Rb, Wwg, Wwg, Rb^Es, Re, Rb, Aa^Fda, Ms, Ha^Fda, Ms, Mm^Xm
Ms^Xm, Mm^Xm, Wwg, Ms, Ms, Ha, Wwg, Rb, Re, Hhd^Fdw, Hhd^Fdw, Rb^Fdw, Rb, Sm, Qxu, Qxu, Qxu, Rb^Fdw, Chr, Rb^Fdw, Sm, Rb^Fdw, Chr, Qxu, Qxu, Hhd, Sm, Sm, Wog, Rb^Fdw, Sm, Rb, Sm, Uh, Rb^Fdw, Qxu, Qxu, Sm, Aa, Qxu, Qxu, Ss, Wwg, Sm, Rb, Sm^Edb, Re^Dr, Aa, Aa, Ha, Ms, Mm
Mm, Ms, Ha, Wwg, Wwg, Wwg, Hhd, Ha, Sm, Rb^Dr, Re, Uh, Sm, Uh, Qxu, Qxu, Chr, Hhd, Chr, Chr, Khr, Qxu, Chr, Hhd, Qxu, Uh, Hhd^Fdw, Sm, Wog, Sm, Rb, Rb, Sm, Sm, Rb^Fdw, Sm, Qxu, Sm, Rb^Fdw, Hhd^Fdw, Qxu, Aa, Wwg, Rb, Sm, Uh^Dr, Uh, Re, Re, Aa^Fda, Ha, Ha
Ms, Ms, Aa, Ha^Fda, Rb, Md, Re, Sm, Rb, Rb^Fdw, Uh, Qxu, Qxu, Uh, Re, Qxu, Qxu, Hhd, Khr, Rb^Fdw, Chr, Qxu, Khr, Hhd, Qxu, Uh, Sm, Rb, Sm, Wog, Wog, Rb^Fdw, Rb^Fdw, Sm, Sm, Rb^Fdw, Rb, Qxu, Rb, Hhd^Fdw, Qxu, Wwg, Ss, Wwg, Rb, Qxu, Sm, Hhd^Fdw, Rb, Aa, Aa^Fda, Mm
Mm, Aa, Aa^Fda, Aa, Re, Rb^Dr, Sm, Sm, Rb^Fdw, Uh, Qxu, Qxu, Rb, Rb, Rb, Rb^Fetd, Qxu, Chr, Sm, Chr, Khr, Chr, Rb, Chr, Qxu, Qxu, Sm, Hhd^Fdw, Sm, Wog, Wog, Sm, Rb^Fdw, Rb^Fdw, Sm, Rb^Fdw, Sm, Qxu, Rb, Hhd^Fdw, Qxu, Rb, Rb^Fdw, Re, Hhd^Fdw, Sm, Rb^Fdw, Hhd^Fdw, Rb^Dr, Aa, Aa, Aa^Fda
Aa, Ha, Aa, Aa, Sm, Sm, Rb^Fdw, Rb^Fdw, Qxu, Rb^Fdw, Qxu, Rb, Rb^Vhr, Rb^Dr, Uh, Qxu, Rb^Fdw, Chr, Khr, Chr, Chr, Chr, Khr, Chr, Rb^Fdw, Qxu, Qxu, Rb^Fetd, Rb^Fdw, Wog, Wog, Rb^Fdw, Rb^Fdw, Rb^Fdw, Qxu, Rb^Fdw, Rb^Fdw, Qxu, Qxu, Qxu, Rb, Re, Rb, Hhd^Fdw, Uh, Qxu, Hhd^Fdw, Re, Rb, Re, Aa, Aa^Fda
Ha, Aa^Fda, Rb, Rb, Sm, Sm^Fdw, Rb^Fdw, Sm, Qxu, Qxu, Rb, Rb, Sm, Rb, Rb^Fdw, Qxu, Chr, Rb^Fdw, Qxu, Qxu, Khr, Rb, Chr, Rb^Fdw, Chr, Rb^Fdw, Rb, Qxu, Rb^Fdw, Wog, Wog, Rb^Vhr, Sm, Rb, Rb, Sm, Sm, Sm, Qxu, Rb, Sm, Rb^Fdw, Rb^Fdw, Sm, Qxu, Re, Sm, Rb, Mm, Re, Aa, Aa^Fda
Ha, Aa^Fda, Rb, Rb, Sm, Sm^Fdw, Sm, Rb, Rb^Fdw, Sm, Hhd, Rb, Rb^Fdw, Rb, Qxu, Qxu, Rb, Hhd^Fdw, Chr, Chr, Rb^Fdw, Chr, Chr, Rb, Rb^Fdw, Sm, Qxu, Qxu, Qxu, Sm, Sm, Wog, Aa, Sm, Rb, Sm, Sm^Fetd, Qxu, Rb, Rb^Vhr, Rb, Hhd^Fdw, Rb^Dr, Qxu, Hhd^Fdw, Rb, Mm, Mm, Mm, Aa, Aa, Aa
Aa, Aa, Re, Rb^Es, Rb^Fdw, Rb^Fdw, Sm^Fdw, Sm, Sm, Rb, Rb^Fdw, Rb^Fdw, Rb, Rb, Qxu, Aa, Aa, Rb^Fdw, Rb, Rb^Es, Chr, Sm, Sm^Fdw, Rb^Fdw, Rb^Fdw, Sm, Rb, Sm, Qxu, Sm, Rb, Wog, Wwf, Aa, Aa, Rb, Rb^Fdw, Rb, Rb, Rb^Fdw, Rb, Sm, Rb, Re, Rb, Rb, Re, Gd, Mm, Ha, Aa, Mm^Xm
Aa^Fda, Rb, Re, Re, Sm, Sm, Rb^Fdw, Sm^Fdw, Rb, Hhd^Fdw, Sm, Rb^Fdw, Rb, Qxu, Rb, Re, Rb^Vhr, Rb, Rb^Edt, Rb^Fdw, Rb, Sm, Rb, Rb, Sm^Fdw, Sm, Rb^Fdw, Rb^Fdw, Qxu, Qxu, Qxu, Sm, Wog, Wwf, Rb, Rb^Edb, Rb, Rb^Fdw, Hhd^Fdw, Rb^Fdw, Rb, Re, Rb, Hhd^Fdw, Qxu, Sm, Re, Rb^Es, Rb, Rb, Aa^Fda, Ms^Xm
Aa, Aa, Rb, Rb, Hhd^Fdw, Rb, Rb^Fdw, Hhd^Fdw, Rb, Sm^Fdw, Sm, Rb, Hhd^Fdw, Qxu, Rb, Rb^Fdw, Qxu, Qxu, Rb^Fdw, Rb, Rb^Fdw, Rb^Fdw, Rb^Fdw, Rb, Sm, Sm^Fdw, Rb^Fdw, Rb^Fdw, Qxu, Sm, Qxu, Rb^Fdw, Wog, Rb^Dr, Rb, Rb, Rb, Ss, Ss, Hhd^Fdw, Rb, Sm, Qxu, Qxu, Uh, Rb, Hhd^Fdw, Rb^Fdw, Rb, Rb, Ms^Xm, Ms^Xm
Aa^Fda, Aa^Fda, Rb, Re, Sm, Rb^Fdw, Sm, Sm^Fdw, Sm^Fdw, Rb, Rb^Fdw, Rb^Fdw, Qxu, Qxu, Rb, Qxu, Rb, Rb^Dr, Rb, Sm, Hhd^Fdw, Sm^Fdw, Qxu, Rb^Fdw, Sm^Fdw, Hhd^Fdw, Sm^Fdw, Sm, Sm, Qxu, Sm, Qxu, Qxu, Wog, Rb^Vhr, Wwg, Rb, Wwg, Hhd^Fdw, Rb, Sm, Uh, Qxu, Rb^Fdw, Hhd^Fdw, Rb, Rb^Fdw, Rb^Fdw, Re, Aa, Ms^Xm, Mm^Xm
Ha^Fda, Aa, Aa, Rb, Rb, Rb^Fdw, Sm^Dr, Rd, Rb^Fdw, Rb, Re, Re, Rb, Qxu, Rb, Qxu, Aa, Rb, Sm, Rb^Fdw, Hhd^Fdw, Sm^Fdw, Rb^Fdw, Qxu, Sm^Fdw, Sm^Fdw, Sm, Qxu, Rb^Fdw, Rb^Fdw, Sm, Sm, Rb^Fdw, Wog, Wog, Wwg, Rb, Ss, Rb^Edt, Rd, Qxu, Qxu, Rb^Fdw, Sm, Hhd^Fdw, Hhd^Fdw, Rb, Hhd^Fdw, Rb, Aa, Aa^Fda, Ms^Xm
Aa, Aa, Aa^Fda, Aa, Re, Hhd^Fdw, Hhd^Fdw, Sm, Rb^Fdw, Rb^Fdw, Sm, Rb, Hhd^Fdw, Rb, Sm, Hhd^Fdw, Qxu, Aa, Rb^Edt, Rb, Rb^Fdw, Rb^Fdw, Qxu, Rb^Fdw, Rb^Fdw, Sm, Sm, Rb^Fdw, Rb^Fdw, Rb^Fdw, Sm, Rb^Fdw, Sm, Wog, Rb, Qxu, Rb, Rb, Rb, Uh, Qxu, Rb^Fdw, Uh, Rb, Qxu, Sm, Qxu, Rb, Rb, Aa^Fda, Aa^Fda, Ms
Ha, Ha^Fda, Aa^Fda, Rb, Rb, Sm, Sm, Rb, Sm, Re, Re, Sm, Rb^Fdw, Qxu, Rb, Rb, Rb, Rb^Vhr, Sm, Rb, Rb^Edt, Rb, Sm, Rb^Edt, Rb^Fdw, Rb, Rb, Hhd^Fdw, Sm, Sm, Qxu, Rb, Wog, Wog, Sm, Qxu, Rb^Edt, Rb^Dr, Qxu, Qxu, Qxu, Qxu, Qxu, Qxu, Rb^Es, Qxu, Rb, Rb, Re, Re, Aa, Aa^Fda
Ha, Ha^Fda, Aa, Aa, Rb, Rb^Dr, Rb^Vhr, Rb, Hhd^Fdw, Rb^Fdw, Rb, Rb, Rb^Fdw, Sm^Fdw, Sm^Fdw, Rb^Fdw, Rb^Fdw, Rb, Sm^Dr, Wwf, Wwf, Sm, Re, Rb^Fdw, Rb, Rb^Fdw, Chr, Hhd^Fdw, Rb^Edt, Qxu, Qxu, Qxu, Wog, Sm, Sm, Hhd^Fdw, Re, Rb^Vhr, Uh, Qxu, Sm, Uh, Hhd^Fdw, Rb, Sm, Sm, Sm, Re, Hhd^Fdw, Rb, Ha, Aa^Fda
Ms, Aa, Aa^Fda, Aa^Fda, Re, Rb, Sm, Rb, Rb, Rb, Sm, Re, Rb, Sm, Qxu, Qxu, Rb^Fdw, Sm^Es, Sm, Wwf, Wwf, Rb, Rb^Edt, Rb, Chr, Hhd^Fdw, Chr, Rb^Vhr, Chr, Sm, Uh, Uh, Sm, Sm, Chr, Chr, Chr, Rb, Rb^Fdw, Qxu, Qxu, Rb, Rb^Fdw, Hhd^Fdw, Rb, Hhd^Fdw, Rb, Hhd^Fdw, Re, Re, Ha^Fpa, Ms^Xm
Ms, Ms, Ha^Fda, Aa^Fda, Aa, Re, Hhd^Fdw, Rb^Fdw, Rb, Sm^Edb, Rb, Rb, Uh, Rb^Fdw, Qxu, Qxu, Chr, Chr, Chr, Rb^Fdw, Rb^Fdw, Rb^Vhr, Sm, Rb, Chr, Chr, Chr, Chr, Chr, Aa, Sm, Sm, Hhd^Fdw, Hhd^Fdw, Chr, 5 Khr, Chr, Rb, Sm, Rb, Hhd^Fdw, Qxu, Rb, Hhd^Fdw, Rb^Fdw, Rb, Re, Rb, Rb, Ha, Ms^Xm, Aa
Aa, Ms, Ha, Aa, Aa^Fda, Sm, Hhd^Fdw, Sm, Rb, Hhd^Fdw, Sm, Rb^Fdw, Qxu, Qxu, Uh, Uh, Chr, 4 Khr, Chr, Rb^Fdw, Qxu, Qxu, Rb^Edt, Chr, Chr, Rb^Edt, 3 Khr, Rb^Edt, Chr, Chr, Sm, Rb^Fdw, Rb^Fdw, Wog, Rb, Chr, Rb^Fdw, Rb, Rb, Sm, Sm, Qxu, Qxu, Hhd^Fdw, Sm, Rb^Fdw, Rb, Rb^Es, Rb, Wwg, Ha^Fpa, Ms^Xm
Aa, Ha, Aa, Aa^Fda, Aa, Rb^Fdw, Hhd^Fdw, Hhd^Fdw, Rb, Rb, Sm^Dr, Hhd, Sm, Uh, Rb, Sm, Aa, Chr, Sm, Aa, Qxu, Qxu, Rb, Rb^Fetd, Chr, Chr, Rb^Edt, Chr, Chr, Hhd^Fdw, Sm, Sm, Qxu, Wog, Re^Es, Re, Uh, Rb, Hhd^Fdw, Rb, Rd, Sm, Sm, Re, Rb, Rb, Hhd^Fdw, Hhd^Fdw, Aa, Ha^Fda, Ha^Fpa, Ms^Xm
Aa^Fda, Aa, Aa^Fda, Aa, Rb, Rb^Fdw, Rb, Rb^Fdw, Rb, Rb^Dr, Qxu, Qxu, Rb^Fdw, Rb, Hhd^Fdw, Sm, Sm, Sm, Rb, Aa, Sm, Rb^Edt, Rb^Fdw, Chr, Qxu, Chr, Chr, Chr, Rb^Fdw, Chr, Rb, Qxu, Rb, Sm, Re, Qxu, Qxu, Rb^Fdw, Sm, Rb, Rb^Fdw, Rb^Fdw, Rb^Fdw, Rb^Fdw, Hhd^Fdw, Rb^Fdw, Rb^Fdw, Rb, Aa, Ms^Xm, Ms^Xm, Ms^Xm
Aa^Fpa, Aa^Fda, Aa^Fda, Aa, Gd, Rb, Aa, Rb^Fdw, Rb, Qxu, Uh^Dr, Uh, Rb, Rb, Rb^Vhr, Rb, Qxu, Rb^Dr, Rb, Aa, Rb, Rb, Rb^Fdw, Rb, Uh, Qxu, Qxu, Chr, Rb^Fdw, Rb^Fdw, Rb^Fdw, Rb, Rb, Sm, Re, Uh, Qxu, Qxu, Sm, Rb, Re, Sm, Re, Sm, Hhd^Fdw, Re, Rb, Aa^Fda, Aa^Fda, Aa^Fda, Aa^Fda, Aa
Aa, Aa, Aa, Aa, Aa, Re, Rb, Re, Sm, Rb, Sm, Sm, Hhd^Fdw, Rb, Sm, Rb, Wwf, Qxu, Sm, Rb, Rb^Fdw, Rb, Rb, Aa, Aa, Qxu, Qxu, Rb^Dr, Rb, Rb, Qxu, Rb, Wog, Wog, Re, Re, Uh, Qxu, Qxu, Uh, Rb, Hhd^Fdw, Rb^Vhr, Sm, Rb, Rb, Rb, Re, Aa, Aa^Fda, Aa, Aa^Fda
Gs^Fp, Aa, Aa, Aa, Aa, Gd, Gd, Re^Es, Rb, Rb, Sm, Rb, Rb, Sm, Rb, Sm, Sm, Qxu, Rb, Rb, Sm, Rb^Edt, Rb^Edt, Rb, Sm, Qxu, Qxu, Uh, Rb^Fdw, Qxu, Uh, Sm, Wog, Rb^Fdw, Sm, Re, Rb, Uh, Qxu, Wwf, Wwg, Rb, Rb, Sm, Rb, Aa, Re, Aa, Gd, Aa, Aa^Fda, Aa^Fda
Hh, Gs^Fdw, Gs^Fdw, Gd, Rb, Aa, Re, Rb, Rb, Sm, Re, Hhd^Fdw, Hhd^Fdw, Re, Sm, Ss, Rb, Uh, Rb, Rb, Rb, Rb^Fdw, Rb, Rb^Fdw, Rb^Fdw, Rb^Fdw, Qxu, Rb^Vhr, Rb, Qxu, Qxu, Sm, Wog, Sm, Sm, Hhd^Fdw, Re^Es, Uh, Uh, Qxu, Wwg, Rb, Sm, Rb, Aa, Rb, Rb, Gd, Aa, Aa, Ms^Xm, Aa^Fda
Ms, Hh, Ha^Fpa, Gd, Rb, Aa, Re, Re, Aa, Rb, Sm, Hhd^Fdw, Rb, Re^Es, Re, Hhd^Fdw, Sm, Qxu, Uh, Rb^Fdw, Rb, Rb^Dr, Qxu, Rb^Fdw, Rb, Rb^Fdw, Qxu, Uh, Rb^Fdw, Rb, Qxu, Sm, Rb^Fdw, Wog, Sm, Hhd^Fdw, Rb, Rb, Qxu, Rb^Fdw, Rb, Rb, Sm, Rb, Re, Rb, Rb, Ha^Fpa, Ha^Fda, Ha, Ms^Xm, Aa
Ms, Ms, Ms, Ha^Fpa, Gd, Aa, Aa, Rb, Rb, Rb, Sm, Hhd^Fdw, Rb, Sm, Re, Sm, Qxu, Qxu, Rb, Rd, Rb^Es, Sm, Sm, Uh, Rb, Hhd^Fdw, Rb, Rb, Rd, Rb, Rb^Fdw, Qxu, Sm, Wog, Sm, Sm, Hhd^Fdw, Re, Qxu, Rb, Sm, Rb, Rb, Hhd^Fdw, Rb, Re, Ha, Hh, Ha^Fda, Ha, Ms, Ms^Xm
Ms^Xm, Ms, Mm, Ha^Fpa, Gd, Gd, Gd, Gd, Aa, Rb, Rb, Sm, Rb, Sm, Sm, Uh, Qxu, Hhd^Fdw, Rb^Fdw, Rb^Fdw, Rb, Sm, Rb, Sm, Rb^Fdw, Hhd^Fdw, Rb, Sm, Uh, Rb, Sm, Uh, Sm, Sm, Sm, Hhd^Fdw, Hhd^Fdw, Re, Uh, Qxu, Sm, Rb^Fdw, Rb^Fdw, Re, Rb, Gd, Ha^Fpa, Ha, Mm, Mm, Mm, Ms
Ms^Xm, Ms, Ms, Hh, Gd, Gs^Fmw, Gd, Gd, Gd, Aa, Rb, Rb^Es, Re, Re^Dr, Rb, Uh, Qxu, Rb, Rb, Rb, Sm, Rb, Re, Rb^Fdw, Rb, Rb, Rb^Fdw, Rb, Qxu, Uh, Sm, Sm, Sm, Wog, Wog, Rb, Sm, Sm, Re, Qxu, Rb, Rb, Rb, Gd, Gd, Ha, Ha^Fpa, Ha, Mm, Mm, Ms, Ms^Xm
Mm^Xm, Mm, Ms, Mm, Gs, Gd, Gs^Fp, Gd, Gd, Aa, Gd, Rb, Aa, Re, Rb, Rb, Sm, Re, Rb^Es, Rb, Rb^Fdw, Uh, Qxu, Qxu, Uh, Rb, Rb^Es, Uh, Qxu, Qxu, Sm, Sm, Rd, Sm, Wog, Sm, Rb^Fdw, Sm, Sm, Sm, Rb^Es, Rb^Es, Rb, Gd, Gd, Ha^Fpa, Ha, Mm, Ms, Ms, Mm^Xm, Mm^Xm
Ms, Ms, Ha, Ha^Fda, Gs, Gd, Hh, Gd, Ss, Gd, Gd, Gd, Gd, Rb, Gd, Rb, Sm, Sm, Rb, Rb, Rb^Fdw, Sm, Qxu, Qxu, Sm, Rb, Sm, Re, Sm, Qxu, Rb, Rb^Fdw, Rb, Sm, Wog, Sm, Re, Rb, Sm, Rb, Rb, Rb, Gd, Gd, Aa, Ha^Fda, Ha, Ha, Ms^Xm, Mm^Xm, Ms^Xm, Mm^Xm
Mm, Hh, Ha^Fda, Ha^Fda, Gs, Gs^Fmw, Gs^Fmw, Ss, Sm, Aa, Gd^Vct, Gd, Hh, Gd, Gd, Rb, Rb, Sm, Rb, Re, Re, Re, Re, Re, Re, Rb, Sm, Rb, Re, Uh, Wwg, Rb, Sm, Sm, Sm, Wog, Rb, Rb^Fdw, Rb, Rb, Co, Gd, Gd, Gd^Vct, Aa, Aa, Mm, Mm, Ms^Xm, Ms^Xm, Ms^Xm, Gs^Fp
Gs^Fp, Gs^Fmw, Gs^Fmw, Gs^Fp, Gs, Ss, Ss, Sm, Sm, Gs^Fp, Gs, Gd, Ha, Mm, Gd, Gd^Vct, Rb, Sm, Rb, Rb^Fdw, Rb, Rb, Re, Rb, Rb, Sm, Re, Re, Re, Rb, Re, Rb, Sm, Rb, Rb, Wog, Re, Re, Gd, Co, Gd^Ecf, Co, Gd, Gd, Ha^Fpa, Ha, Ms, Ms, Ms^Xm, Mm^Xm, Ms, Ms
Gs^Fp, Aa, Gs^Fmw, Gs^Fmw, Ss, Wwg, Wwg, Ss, Wwg, Sm, Co, Co, Co, Mm, Mm, Gd, Gd, Rb, Gd, Rb, Gd^Vct, Gd, Gd, Rb, Gd, Rb, Gd^Vct, Rb, Re, Rb, Rb, Re, Rb, Rb, Re, Wog, Ss, Re, Co, Co, 2 Ko, Co, Co, Gd, Aa, Ms, Mm, Ms, Ms^Xm, Mm^Xm, Ms, Ms
Hh^Fp, Gs^Fp, Gs, Sm, Wwg, Ss, Wwg, Wwg, Ss, Sm, Co, Ha, Co, Hh, Ha, Mm, Gd, Gs, Ha^Fda, Gd, Gd, Gd, Co, Gd, Gd, Gd, Co, Gd, Gd, Gd, Gd, Gd^Vct, Gd, Gd, Re, Wwg, Gd, Ss, Co, Gd^Ecf, Co, Gd^Ecf, Co, Gd, Gs, Mm, Mm, Ms, Mm^Xm, Ms, Ms^Xm, Ms
Mm, Mm, Ha^Fda, Wwg, Gs^Fmw, Wwg, Sm, Ss, Gs, Co, Gs^Fp, Ko, Gs^Fp, Co, Gs, Ha^Fda, Co, Gd, Gd, Gd, Gd, Co, Gd^Ecf, Co, Co, Co, Gd^Ecf, Co, Aa, Gd, Gs, Gd, Co, Gd, Gd, Re, Gd^Vct, Wwg, Wwg, Co, Gd, Co, Aa, Gs, Gs, Gs, Mm, Mm^Xm, Ms^Xm, Ms, Ms^Xm, Ms
Ms, Ms, Mm, Wog, Ha^Fpa, Gs^Fmw, Gs^Fmw, Gs, Gs^Fp, Co, Co, Co, Co, Co, Gs^Fp, Co, Gd^Ecf, Co, Co, Co, Co, Co, Co, Co, Co, Co, Co, Co, Co, Co, Co, Co, Gd^Ecf, Co, Gs^Fp, Gd, Hh, Gd, Wwg, Gs, Gs^Ve, Gs, Gs, Gs, Ha, Gs^Fdw, Mm, Ms^Xm, Mm, Ms, Ms, Ms
Ms, Mm, Mm, Wog, Mm, Ha^Fpa, Ha, Gs^Fp, Gs, Gs, Aa, Aa, Aa^Fpa, Aa, Gs, Co, Co, Co, Co, Gd^Ecf, Co, Co, Co, Co, Ko, Co, Co, Co, Co, Gd^Ecf, Co, Co, Co, Co, Hh^Fmw, Hh, Ha^Fpa, Ha^Fpa, Wog, Wog, Hh, Ha^Fpa, Hh, Hh, Mm, Ms^Xm, Ms^Xm, Mm^Xm, Ms^Xm, Ms, Ms^Xm, Ms^Xm
Ms^Xm, Ms, Ms, Wog, Mm, Ha^Fda, Ha, Gs^Fp, Gs, Aa, Aa^Fpa, Aa^Fpa, Aa, Aa^Fp, Gs^Fmw, Gs^Fp, Gs^Fp, Gs^Fmw, Gs, Co, Aa^Fda, Co, Co, Co, Co, Co, Co, Co, Aa, Co, Aa, Gs, Hh^Fmw, Hh^Fmw, Hh, Ha^Fpa, Mm, Ha, Mm, Wog, Mm, Ha, Mm, Mm, Ms^Xm, Ms^Xm, Ms^Xm, Mm^Xm, Ms, Ms, Ms, Ms
Ms^Xm, Ms^Xm, Mm^Xm, Ms, Ms, Hh, Hh, Hh, Gs^Fp, Gs^Fp, Aa, Gs^Fp, Gs^Fp, Gs, Hh, Gs^Fmw, Gs, Gs^Fp, Gs^Fp, Aa, Aa^Fda, Co, Gd^Ecf, Co, Co, Co, Gd^Ecf, Co, Aa, Aa, Gs^Fp, Gs^Fmw, Hh, Hh, Ha^Fda, Ha, Mm, Mm, Mm, Wog, Wog, Mm, Mm^Xm, Mm^Xm, Ms^Xm, Ms^Xm, Ms, Ms, Mm^Xm, Mm^Xm, Ms, Mm^Xm
Mm^Xm, Ms^Xm, Mm, Mm, Ms, Mm, Mm, Ha^Fda, Gs, Gs^Fp, Gs, Gs^Fmw, Hh, Hh, Ha, Gs^Fp, Ha^Fda, Gs^Fmw, Gs^Fp, Gs^Fp, Aa^Fda, Co, Co, Co, Aa, Co, Co, Co, Gs^Fmw, Gs^Fmw, Gs, Hh, Ha^Fda, Ha^Fda, Hh, Mm, Ms, Ms, Mm^Xm, Mm^Xm, Mm^Xm, Mm^Xm, Mm^Xm, Ms^Xm, Ms, Mm^Xm, Ms, Ms^Xm, Ms, Ms^Xm, Ms, Ms
Mm^Xm, Mm^Xm, Mm^Xm, Mm, Mm, Mm, Hh, Ha^Fda, Gs, Gs^Fp, Gs, Ha, Hh, Hh, Hh, Ha^Fda, Hh^Fp, Ha^Fda, Hh^Fp, Hh, Gs, Gs, Gs, Aa, Gs^Fmw, Gs^Fp, Gs^Fmw, Gs^Fmw, Gs^Fmw, Gs^Fdw, Hh, Hh^Fp, Hh, Ha, Ha^Fda, Mm, Mm, Mm^Xm, Ms, Mm^Xm, Ms, Ms, Ms, Mm^Xm, Ms^Xm, Ms, Ms, Ms, Ms^Xm, Ms^Xm, Ms, Ms
Mm^Xm, Mm^Xm, Ms^Xm, Mm, Mm^Xm, Hh, Ms, Gs, Ha, Gs, Hh, Hh, Gs^Fp, Gs, Gs, Hh, Gs^Fmw, Gs^Fmw, Hh^Fmw, Gs, Hh^Fp, Gs^Fp, Gs^Fmw, Gs^Fmw, 1 Hh^Fp, Gs, Gs^Fp, Gs, Hh^Fp, Hh, Gs^Fmw, Gs, Hh, Gs, Aa^Fdw, Gs, Ms^Xm, Ms, Ms^Xm, Ms^Xm, Mm^Xm, Mm^Xm, Ms^Xm, Ms, Ms, Ms^Xm, Ms^Xm, Ms^Xm, Ms^Xm, Ms^Xm, Ms, Ms
Mm^Xm, Mm^Xm, Mm^Xm, Mm^Xm, Mm^Xm, Mm^Xm, Mm, Ms, Gs, Hh, Gs, Gs^Fp, Gs, Ha, Mm, Gs, Gs, Hh, Hh, Hh, Hh, Gs, Gs, Gs, Gs, Hh, Gs^Fp, Gs, Gs, Hh^Fmw, Gs, Hh, Gs, Gs^Fmw, Gs^Fmw, Ms^Xm, Gs^Fmw, Ms, Ms, Ms, Ms, Ms, Ms, Ms, Gs, Ms, Ms, Ms, Ms, Ms, Ms, Ms
