border_size=1
usage=map

Ms, Ms, Ms, Ms, Ms, Ms, Ha, Gd, Gd, Ha, Ha, Ha, Ha, Ha, Ha, Ms, Ms, Ms, Ms^Xm, Ms^Xm, Ms^Xm, Ms^Xm, Ms^Xm, Ms^Xm, Ms^Xm, Ms^Xm, Ms^Xm, Ms, Ms, Ms, Ms, Ms, Ms, Ms, Ms, Ms, Ms, Ha, Ha^Fma, Ha, Ha^Fma, Ha, Ha, Ms, Ms, Ms, Ms, Ms, Ms^Xm, Ms^Xm, Ms^Xm, Ms^Xm, Ms^Xm, Gd, Ms^Xm, Ms, Ms, Ms, Ha, Ai, Ai, Ai
Ms, Ms, Ms, Ms, Ha, Ms, Ha, Ha, Gd, Gd, Ha, Ha, Ha, Ha, Ha, Ha, Ms, Ms, Ms, Ms^Xm, Ms^Xm, Ms^Xm, Ms^Xm, Ms^Xm, Ms^Xm, Ms^Xm, Ms^Xm, Ms, Ms, Ms, Ai, Ms, Ha, Ms, Ha, Ms, Ms, Ha^Fma, Ha^Fma, Ha^Fma, Ha, Ha, Ha, Ms, Ms, Ms, Ms, Ms, Ms^Xm, Ms^Xm, Ms^Xm, Ms^Xm, Ms^Xm, Ms^Xm, Ms^Xm, Ms, Ms, Ms, Ms, Ha, Ha, Ai
Ms, Ms, Ms, Ms, Ha, Ha, Ha, Ha, Ha, Aa, Aa, Ha, Aa, Ha, Ha, Ms, Ms, Ms, Ms, Ms, Ms, Ms^Xm, Ms^Xm, Ms^Xm, Ms^Xm, Ms^Xm, Ms^Xm, Ms^Xm, Ms^Xm, Ai, Ms, Ms, Ha, Ms, Ms, Ha, Ms, Ha, Ha, Aa, Aa, Ha, Aa, Ha, Ms, Ms, Ai, Ms^Xm, Ms^Xm, Ms^Xm, Ms^Xm, Ms^Xm, Ms^Xm, Ms^Xm, Ms^Xm, Ms^Xm, Ms, Ms, Ms, Ms, Ha^Fpa, Ha^Fpa
Ms^Xm, Ms, Ms, Ms, Ms, Ms, Ms^Xm, Ha, Ha^Fpa, Ha^Fpa, Aa, Aa, Aa, Aa, Aa, Ha^Vha, Ha, Ms, Ms, Ms, Ms, Ms, Ms, Ms^Xm, Ms^Xm, Ms^Xm, Ms^Xm, Ms^Xm, Ms^Xm, Ha, Ha, Ms, Ms, Ms, Ms, Ms, Ms, Ha, Ha^Fpa, Ha, Ha, Ha^Fpa, Ha^Fpa, Ha^Fma, Ha^Fma, Ha, Ms, Ai, Ha, Ms^Xm, Ms, Ms^Xm, Ms, Ms, Ai, Ms^Xm, Ms, Ms, Ms, Ms, Ha^Fpa, Ha
Ms^Xm, Ms^Xm, Ms^Xm, Ms, Ms, Ms, Ms^Xm, Ms^Xm, Ms, Ha^Fpa, Ha, Ha^Fpa, Aa, Aa^Fpa, Aa, Aa, Gd, Ha^Fpa, Ha, Ms, Ms, Ms, Ms, Ms, Ha, Ms, Ms, Ms^Xm, Ms, Ms, Ha, Ms, Ms, Ms, Aa, Ms, Aa, Ha^Fpa, Ha, Ha, Ha, Aa, Ha, Ha, Ha, Ms, Ms, Ms, Aa^Fpa, Ms, Ms, Ms, Ha^Fpa, Ms, Ms, Ai, Ms, Ms, Ms, Ms, Ha, Ha^Fpa
Ms^Xm, Ms^Xm, Ms^Xm, Ms^Xm, Ms^Xm, Ms^Xm, Ms^Xm, Ms^Xm, Ms^Xm, Ms, Ms, Ha, Ha^Fma, Aa, Aa, Aa, Aa, Ha^Fpa, Ha^Fpa, Ha^Fpa, Ha, Ms, Ms, Ms, Ha, Ms, Ms, Ms, Ms, Ms, Ha^Fpa, Ha, Ms, Ms, Ha, Aa, Ha, Ha, Aa, Aa, Ha, Aa^Fpa, Aa^Vha, Aa, Ha^Fma, Ha, Ha, Ms, Ms, Aa^Fpa, Ha^Fpa, Ha, Ms, Ms, Ha, Ms, Ha, Ms, Ha, Aa, Aa, Ha
Ms^Xm, Ms^Xm, Ms^Xm, Ms^Xm, Ms^Xm, Ms^Xm, Ms^Xm, Ms^Xm, Ms^Xm, Ms, Ms, Ha^Fma, Ha^Fma, Gd, Aa, Aa, Aa, Wwg, Wwg, Ha, Aa, Ha, Ha^Vha, Ha, Ha, Ha, Ms, Ha, Ha, Ha, Ha^Fpa, Ha^Vha, Ha, Ha, Ha, Ha^Fma, Ha^Fma, Ha, Aa, Ha, Aa, Aa, Ha, Aa, Ha, Ha^Fma, Ha, Aa, Aa, Ms, Aa, Ms, Ms, Ms, Ha^Fpa, Aa, Ha^Fpa, Ha^Fpa, Ha^Fpa, Ha, Aa, Gd
Ms^Xm, Ms^Xm, Ms^Xm, Ms^Xm, Ms^Xm, Ai, Ms, Ms^Xm, Ms, Ms, Ms, Ha^Fma, Ha^Vha, Aa, Aa, Aa, Aa, Wwf, Wwg, Ha, Ha^Fma, Ha, Ha^Fma, Ha^Fma, Aa, Ha, Ha, Ms, Aa, Ms, Ha, Aa^Fpa, Ha, Aa, Aa, Ha^Fma, Aa, Aa, Gd, Aa, Aa^Fpa, Ha, Ha, Ha, Wwg, Ha, Aa, Ha, Aa, Ha, Aa, Aa, Ha^Fma, Ha^Fma, Ha^Fma, Ha, Aa, Ha, Aa, Aa, Aa, Gd
Ms^Xm, Ms^Xm, Ms^Xm, Ms^Xm, Ms^Xm, Ms^Xm, Ms, Ms, Ms, Ha, Ha, Ha^Fma, Ha, Gs, Aa, Aa, Gs, Aa, Aa, Ha, Aa, Ha^Fma, Ha, Ha, Ha^Vha, Ha, Ha, Ha, Aa^Fma, Aa, Aa, Aa^Fpa, Aa, Aa, Aa, Aa, Gs, Aa, Gd, Aa, Aa^Fpa, Aa^Fpa, Aa, Wwg, Wwg, Aa, Aa, Gd, Aa, Aa, Aa^Fpa, Aa^Fpa, Aa, Ha^Vha, Gd, Aa, Aa, Aa, Gd, Gd, Aa, Gd
Ms, Ms, Ha^Fpa, Ha^Fpa, Ha^Fpa, Ms, Ms, Ms, Ms, Ms, Ha, Ha^Fma, Ha, Gs, Ha, Gs, Cha, Cha, Cha, Gd, Gd, Aa, Aa^Fpa, Aa^Fpa, Aa, Hhd, Aa, Aa, Aa^Fpa, Aa^Fma, Aa^Fpa, Aa^Fpa, Gd, Gs, Gs, Gd, Aa, Gd, Aa, Gd, Sm, Aa^Fpa, Wwf, Wwg, Wwf, Ss, Aa^Vha, Gd, Aa, Gd, Aa, Aa^Fpa, Gd, Aa, Gd, Aa, Aa, Gd, Gd, Gd, Aa, Gd
Ms, Ms, Ms, Ha^Fma, Ha^Fpa, Ms, Ms, Ms, Ha^Fpa, Ha^Fpa, Ha, Ha, Aa, Ha^Fpa, Aa, Ha, Cha, Cha, 3 Kha, Cha, Cha, Aa^Fpa, Gd^Fpa, Aa^Fpa, Hhd, Aa, Aa, Aa^Fpa, Aa^Fpa, Aa, Wwg, Aa, Aa^Fma, Aa, Aa^Fpa, Aa^Fpa, Aa, Gd, Gd, Gll^Fp, Wwf, Wwf, Wwf, Wwf, Ha, Aa, Aa^Fpa, Aa^Fpa, Aa, Aa, Gs, Gs, Aa, Aa, Aa, Gd, Aa, Gd, Ha, Gd, Gd, Gd
Ha, Ha, Ms, Ms, Ha^Fma, Ha^Fma, Ha, Ha^Fpa, Ha^Fma, Aa^Fma, Ha, Ha, Ha^Fpa, Ha^Fpa, Ha, Ha, Gd, Cha, Cha, Cha, Cha, Gd, Aa^Fma, Gd, Gd, Gd, Gd, Aa, Aa, Aa^Fpa, Wwg, Wwg, Aa^Fma, Aa^Fpa, Aa^Fma, Aa^Fpa, Aa, Gd, Gd, Aa, Aa^Fma, Ss, Sm, Ha^Fpa, Ha^Fpa, Aa, Aa^Fpa, Aa^Fpa, Aa^Fma, Aa, Aa, Gs, Ha, Gd, Aa, Aa, Ha^Vha, Ha, Ai, Ha, Aa, Aa
Aa, Ha, Ha, Ms, Ms, Ms, Ms, Ms, Ha^Fma, Ha^Vha, Aa, Aa, Ha^Fpa, Ha^Fpa, Ha^Fpa, Ha, Aa^Fpa, Aa, Gs, Cha, Hhd, Aa^Fma, Aa^Fma, Aa^Fpa, Gd^Fpa, Aa, Aa^Fpa, Aa^Fpa, Wwf, Wwg, Wwg, Wwg, Wwg, Aa^Fma, Aa, Aa, Gd, Gd, Aa^Fpa, Gd, Aa^Fma, Gd, Gd, Ha, Gd, Aa, Gd, Aa, Aa^Fma, Aa^Fma, Gd, Ha, Ha^Fpa, Aa, Aa^Fpa, Ha^Fpa, Ha, Ha, Ai, Ai, Ha, Gd
Aa, Aa, Aa, Ha, Ha^Fpa, Ms, Ha, Ha, Ha^Fpa, Ha^Fma, Aa, Aa, Ha, Aa, Aa, Aa^Fpa, Aa, Aa, Gd, Gs, Gd, Hhd, Gd, Aa^Fma, Hhd, Hhd, Gd, Aa, Gd, Wwf, Wwf, Wwf, Ss, Ss, Aa^Vha, Aa, Gd, Gd, Aa^Fpa, Aa^Fpa, Gd, Gd, Gd, Gd, Gd, Aa, Wwf, Ss, Aa^Fma, Aa, Ha^Fma, Ha^Fpa, Ha, Ha^Fpa, Ha^Fpa, Ha^Fpa, Ms, Ai, Ai, Ai, Ai, Ha
Aa, Aa, Aa, Aa, Aa, Aa, Aa, Aa^Fpa, Aa, Ha, Aa, Ha, Ss, Aa, Gd, Aa, Gd, Aa, Ha, Ha, Ha^Vha, Gd, Aa, Aa, Aa^Fpa, Gd, Gs, Aa, Hhd, Ss, Aa, Aa, Wwf, Gs, Gd, Gs, Aa, Aa^Fpa, Aa^Fpa, Aa, Aa, Gd, Aa, Aa, Aa, Ss, Wwf, Wwg, Aa, Ha^Fma, Ha, Ha, Ms, Aa, Ms, Ha, Ha, Ha, Ha, Ai, Ai, Ha
Ha^Fpa, Aa, Aa, Aa, Aa, Aa, Aa, Aa, Gd, Aa, Wwg, Wwg, Ss, Aa, Aa, Gd, Ha, Ha^Fpa, Ha^Fma, Ha^Fma, Ha, Hhd^Fp, Gll^Fp, Aa, Aa^Fpa, Aa^Fpa, Aa^Fpa, Aa^Vha, Aa, Aa, Gd, Aa, Gd, Sm, Sm, Gd, Wwf, Gd^Fpa, Gd, Gd, Gd, Gd, Aa^Fpa, Aa^Fpa, Aa^Fpa, Aa, Ss, Wwf, Aa, Ha, Ha, Ha, Ms, Ms, Ms, Ha, Ms, Ms, Ms, Ms, Ai, Ha
Ha, Ha^Fpa, Ha^Fpa, Ha, Ha^Fma, Aa, Ha^Vha, Aa, Ha, Ss, Wwg, Wwg, Aa, Gd, Gd, Aa, Gd, Gd, Gd, Ha^Fpa, Ha, Hhd^Fp, Hhd^Fp, Aa, Aa, Aa^Fpa, Aa^Fma, Aa^Fpa, Aa, Aa, Hhd, Gd, Gd, Gll^Fmw, Gll^Fmw, Ss, Ss, Wwf, Gd, Gd^Vo, Aa, Aa, Aa^Fpa, Aa^Fpa, Aa, Gd, Gd, Aa, Aa^Fpa, Ha^Vha, Ms, Ms, Ms, Ms, Ha, Ms, Ha, Ha, Ai, Ai, Ha, Ms
Ms, Ms, Ms, Ha, Ms, Ha, Ms, Ha^Fpa, Ha, Ha^Fpa, Aa, Wwg, Aa, Aa, Gd, Gd, Gd, Aa, Aa, Aa, Aa, Gd, Gd, Gd, Aa, Aa^Fma, Wwf, Wwg, Aa, Hhd, Aa, Gd, Gd, Gll^Fmw, Gd, Ss, Gd, Wwf, Wwf, Gd, Wwf, Sm, Sm, Aa^Fma, Gs, Aa, Gd, Aa^Fpa, Aa^Fpa, Aa, Ms, Ms, Ms, Ms, Ms^Xm, Ha, Ms^Xm, Ms^Xm, Ms^Xm, Ms, Ms, Ms
Ms, Ms, Ms, Ms, Ms, Ms, Ms, Ms, Ms, Ha, Ha^Fma, Aa, Gll^Fmw, Gd, Aa, Gs, Gd, Aa, Aa^Fpa, Gd^Fpa, Gd^Vo, Gd, Gd, Sm, Wwf, Aa, Wwf, Wwg, Ss, Aa, Gd, Gd, Gs, Gd, Aa, Aa, Aa^Fpa, Aa, Ss, Wwf, Wwf, Wwg, Wwg, Aa, Gd, Gs, Aa, Aa^Fpa, Aa^Fma, Aa, Ha^Fma, Ms, Ha, Ms^Xm, Ms^Xm, Ms^Xm, Ms^Xm, Ms^Xm, Ms^Xm, Ms, Ms, Ms
Ms^Xm, Ms, Ms, Ms, Ai, Ms, Ms, Ms, Ms, Ha, Ha, Ha^Fpa, Gd, Gd, Gs, Gs, Gd^Fpa, Aa^Fpa, Aa^Fpa, Gd, Gd, Gd, Aa, Sm, Gs, Wwf, Sm, Wwf, Gd, Aa, Aa, Gd, Gd, Gd, Gd, Aa^Fpa, Aa^Fma, Aa^Fpa, Aa^Fpa, Ss, Aa, Wwg, Gd, Aa, Gd, Aa^Fpa, Aa^Fpa, Aa^Fma, Gd, Ha, Ms, Ha^Fma, Ha, Ms, Ms^Xm, Ms^Xm, Ms^Xm, Ms^Xm, Ms^Xm, Ms^Xm, Ms^Xm, Ha
Ms^Xm, Ms^Xm, Ms^Xm, Ai, Ms, Ai, Ai, Ms, Ha, Ha, Aa, Ha, Aa, Gd, Gs, Gd, Aa^Fpa, Aa^Fpa, Aa^Fpa, Gd^Fpa, Gd, Gd, Aa, Gd, Wwg, Gs, Gd, Gd, Aa^Fma, Aa^Fma, Aa^Fma, Hhd, Hhd, Aa^Voa, Aa^Fma, Gd, Aa^Fma, Aa^Fpa, Gd, Aa, Gd, Gd, Gd, Gd, Gd, Aa, Aa, Aa, Aa, Aa, Ha, Ms, Ms, Ms, Ha^Fma, Ms^Xm, Ha^Fpa, Ha^Fpa, Ms^Xm, Ms^Xm, Ms^Xm, Ms^Xm
Ms^Xm, Ms^Xm, Ms^Xm, Ms, Ms, Ai, Ms, Ai, Ai, Ai, Ai, Aa, Aa^Vha, Gd, Ai, Aa^Fpa, Gd^Fpa, Aa^Fma, Aa^Fpa, Gd, Aa, Gd, Ss, Wwf, Wwg, Aa, Wwf, Aa^Fma, Aa^Fma, Aa^Fma, Hhd^Fma, Hhd, Wwf, Aa, Aa^Fpa, Aa^Fma, Aa^Fma, Aa^Fpa, Aa, Gd, Gs, Gs, Gll^Fp, Gd, Gd, Aa^Voa, Aa, Ha, Ha^Fpa, Ha^Fpa, Aa, Ms, Ms, Ms, Ha^Fma, Ms, Ha^Fpa, Ms, Ms, Ms^Xm, Ms, Ms^Xm
Ms^Xm, Ms^Xm, Ms^Xm, Ms, Ms, Ms, Ha, Ha, Ha^Fma, Aa, Aa, Ai, Ai, Ai, Ai, Ai, Gd, Aa^Fma, Gd, Gd, Ss, Ss, Wwf, Wwf, Wwg, Aa, Gd, Wwf, Gd, Aa, Aa, Ss, Gd, Aa, Wwf, Aa, Wwf, Sm, Sm, Wwf, Wwf, Gd, Gd, Gll^Fmw, Gll^Fmw, Gd, Gd, Gd, Ha, Ha^Fpa, Aa, Ha, Ha^Fma, Ms, Ms, Ha, Ms, Ms, Ms, Ms, Ms, Ms
Ms^Xm, Ms^Xm, Ms^Xm, Ms, Ms, Ha, Ha, Ha^Fma, Ha, Ha^Fma, Ha, Aa, Gd, Ai, Ai, Ai, Gd, Gd, Gs, Hhd, Hhd, Sm, Sm, Wwg, Gd, Gd, Gs, Gd, Gd, Aa, Co, Co, Co, Gd, Gd, Wwf, Gll^Fp, Gll^Fmw, Wwf, Wwf, Wwg, Wwg, Gd, Gll^Fmw, Gll^Fp, Gd, Gd, Hhd, Gd, Ha, Aa, Aa, Ha, Ms, Ha^Fpa, Ha, Ha^Fpa, Ha, Ha, Ms, Ms, Ms
Ms^Xm, Ms^Xm, Ms, Ms, Ms, Ms, Ms, Ms, Ms, Ha, Ha^Fpa, Ha, Gd, Aa, Gd, Gd, Gll^Fp, Gd, Gs, Hhd, Gd, Gd, Gd, Gd, Gs, Gs, Gs, Ss, Ss, Gd, Co, Co, 1 Ko, Co, Co, Gd, Gd, Wwf, Sm, Aa, Aa^Fpa, Aa, Aa^Fpa, Gd, Gd, Gd, Gd, Gs, Aa, Aa^Fpa, Ha, Aa, Aa, Ha, Ha^Fma, Ha, Aa, Ms, Ha^Fma, Ha, Aa^Fpa, Aa
Ms^Xm, Ms^Xm, Ms, Ms, Ms, Ms, Ms, Ms, Ms, Ha, Ha, Aa, Aa, Aa, Aa, Aa, Sm, Gd, Gd, Gs, Aa, Aa, Gd, Gs^Fma, Gd, Gd, Gd, Wwg, Ss, Ss, Aa^Fma, Co, Co, Co, Co, Gd, Gd, Gd, Gd^Fpa, Aa^Fpa, Aa, Aa^Fpa, Aa, Aa, Gs, Gs, Hhd, Gd, Aa, Aa^Fma, Aa^Fma, Ha, Ha, Ha, Aa, Ha, Aa, Ha^Fma, Ha, Aa^Fpa, Aa^Fpa, Aa
Ms^Xm, Ms, Ms, Ms, Ha, Ms, Ms, Ms, Ha, Ha, Ha^Fma, Aa, Gd, Aa, Wwg, Wwf, Sm, Gd, Gd, Gd, Gs, Gd, Gd, Gd, Aa, Gd, Aa^Voa, Gd, Gd, Gd, Aa^Fma, Aa^Fma, Gd, Co, Gd, Gd, Gd, Aa, Aa^Fma, Aa, Aa^Fpa, Hhd^Fpa, Aa, Aa, Gd, Aa, Hhd, Hhd, Gd, Gd^Ve, Gs, Aa^Fma, Aa, Aa^Fpa, Aa, Aa^Fpa, Aa, Aa, Aa^Fma, Aa^Fma, Gd, Aa
Ha, Ms, Ms, Ms, Ms, Ha, Ha^Fma, Ha, Aa, Aa, Aa, Aa, Gs, Wwg, Wwf, Wwf, Gd, Aa, Gd, Gd, Gd, Gd, Gd, Gd, Gd^Fma, Aa^Fma, Aa^Fma, Gd, Aa, Gd, Gd, Aa^Fma, Gd, Gd, Gd, Gd, Gd, Aa^Fma, Hhd^Fma, Hhd, Gd, Gd, Gd, Aa, Aa, Gd, Aa^Fma, Gd, Gd, Gd, Gs, Gs, Gd, Aa, Aa, Aa, Gs, Gd, Gd, Aa, Gd, Gd
Ha, Ha^Fpa, Ha, Ha, Ha^Fpa, Ha, Gd, Ha, Gd, Gd, Aa^Vca, Aa, Aa, Sm, Wwf, Wwg, Hhd, Gd, Aa, Aa, Gd, Aa^Vca, Aa, Gd^Fma, Gd, Aa, Ss, Gd, Gd, Aa, Gd, Gd, Gd, Wwf, Wwf, Gs, Aa, Aa^Voa, Gd, Gd, Gd, Gd, Gd, Gd, Ss, Aa, Aa, Aa^Fma, Aa^Fma, Gs, Gs, Aa, Aa, Gs, Aa^Fma, Aa^Fma, Aa, Aa, Gd, Gs, Gd, Gd
Aa^Fma, Aa, Aa^Fma, Aa^Fma, Aa, Aa^Fma, Aa^Fma, Aa, Aa, Aa, Aa^Fpa, Gd, Gd, Gd, Aa, Hhd, Gd, Gd, Gd, Gd, Gd, Wwf, Wwg, Gd, Ss, Ss, Gs, Gd, Hhd^Fmw, Ss, Wwf, Wwf, Gd, Wwf, Wwf, Wwf, Gd, Gs, Gd, Gd, Gll^Fmw, Gll^Fmw, Gd, Wwf, Wwf, Aa, Aa^Fma, Aa, Aa^Fma, Aa^Fma, Aa, Gs, Hhd, Aa, Gd, Aa^Fma, Gd, Aa, Gs, Gs, Aa, Gd
Aa, Aa^Fma, Aa, Aa^Fma, Aa, Aa^Fma, Aa, Aa, Gd, Aa^Fpa, Aa, Gd, Gd, Aa, Gd, Gd, Aa^Fpa, Aa, Aa^Fpa, Aa, Wwf, Wwf, Wwf, Wwf, Wwg, Gd, Gd, Gd, Gll^Fmw, Wwf, Gd, Sm, Ss, Ss, Wwg, Gd, Gd, Gd, Gd, Wwf, Wwf, Hhd^Fmw, Ss, Wwg, Wwg, Aa^Fma, Aa^Fma, Aa, Aa, Aa, Aa, Gd, Gd, Hhd, Aa, Gd, Aa^Fpa, Gd^Fma, Aa^Fpa, Aa, Ha, Ha
Gs, Gs, Aa, Gs, Gd, Aa, Aa, Aa, Aa, Aa, Gd, Gd, Gd, Gll^Fp, Gll^Fp, Aa, Gd, Aa^Fpa, Aa, Sm, Sm, Wwf, Ss, Ss, Wwg, Gs, Aa^Fpa, Gd, Gd, Gd, Gd, Sm, Sm, Ss, Wwf, Wwg, Ha^Fpa, Ha, Aa, Wwf, Gs, Gd, Aa, Wwg, Wwg, Wwg, Gd, Gd, Gd, Aa, Gd^Fma, Aa^Fpa, Aa^Fpa, Aa, Aa^Fpa, Aa^Fpa, Gd, Aa, Ha^Fpa, Aa^Fpa, Ms, Ha
Gd, Aa, Aa^Vca, Aa, Gll^Fp, Gd, Gd, Gd, Gd, Gd, Aa^Fpa, Gd, Aa^Fpa, Gd, Gll^Fp, Gd, Gd, Gd, Gd, Gd, Gd, Gd, Gd^Fpa, Gd, Gd, Aa, Aa^Fpa, Aa, Gd, Gd, Gd, Aa^Voa, Aa, Ss, Wwf, Wwg, Aa^Fpa, Aa^Fpa, Gd, Gd, Aa, Gs, Gs, Aa, Aa, Gd, Aa, Gd, Gs, Gd, Gd^Fma, Aa^Fpa, Aa^Fma, Gd^Ve, Aa, Aa, Ha^Fpa, Aa, Aa, Aa^Fpa, Ms, Ms
Aa, Gd, Gd, Aa, Gs, Aa, Aa, Gd, Gd, Aa^Fpa, Aa, Aa^Fpa, Wwg, Sm, Wwf, Wwf, Wwf, Gd, Hhd, Hhd, Hhd, Gd, Aa^Vca, Aa^Fpa, Hhd^Fpa, Gd, Gd^Fma, Aa^Fpa, Aa^Fma, Gd, Gd, Gd, Aa, Gd, Hhd, Gd, Gd, Aa^Fpa, Gd, Aa, Aa^Fpa, Aa, Gd, Aa, Aa, Aa, Aa, Aa, Aa, Gd, Gd, Gd^Fma, Aa, Aa, Ha^Fma, Ha, Ha^Fma, Ha, Ms, Ms, Ms, Ms
Aa, Gd, Aa, Aa^Fpa, Aa, Gs, Hhd, Hhd, Aa, Gd, Aa, Sm, Wwf, Wwf, Wwf, Wwf, Gll^Fmw, Gd, Gd, Hhd, Gd, Gd, Gd, Hhd^Fpa, Aa^Fpa, Gd, Aa, Aa, Aa^Fma, Aa^Fma, Aa^Fma, Gd, Gd, Hhd, Gd, Gd, Aa^Fma, Gd, Gd, Aa^Fpa, Aa^Fpa, Aa^Fpa, Gd, Gd, Gd, Gd^Ve, Gd, Aa, Gd, Gd, Hhd, Gd, Aa^Fpa, Aa^Fma, Ha, Ha^Fma, Ha, Ms, Ms, Ms, Ms, Ms
Ha, Aa^Fpa, Aa^Fpa, Aa^Fpa, Gd, Gd, Gd, Gd, Aa, Aa, Aa^Fma, Wwg, Wwg, Wwg, Wwf, Sm, Gll^Fmw, Gll^Fmw, Gd, Aa, Aa, Gd, Gd, Aa^Fpa, Aa^Fpa, Aa, Aa^Fpa, Gd, Aa, Aa^Fma, Aa^Fma, Aa, Gd, Aa, Aa^Fma, Aa^Fma, Aa^Fma, Gs, Aa, Gd, Gd, Aa, Gd, Aa, Hhd, Hhd, Aa, Aa, Gd, Hhd, Gd, Aa, Ha, Ha, Ai, Ai, Ai, Ai, Ai, Ms, Ms^Xm, Ms^Xm
Ha^Fpa, Ha, Ha^Fpa, Aa, Aa, Ha, Ha, Aa, Ha^Fma, Aa^Fma, Aa^Fma, Aa, Aa, Aa, Sm, Sm, Gd, Gd, Gd, Aa, Gs, Gs, Aa, Gd, Gd, Aa^Fpa, Aa, Aa, Gd, Aa^Fma, Gd, Aa, Gd, Gd, Aa, Aa^Fma, Aa, Gd, Aa, Aa, Aa, Gd, Aa, Aa, Aa, Gd, Aa, Aa, Aa, Aa, Aa, Ha, Ai, Ai, Aa, Ha, Ms, Ai, Ms^Xm, Ms^Xm, Ms^Xm, Ms^Xm
Ha, Aa^Fpa, Aa, Aa^Fma, Aa^Fpa, Aa, Ha, Aa, Ha, Ha, Ha, Aa^Fma, Aa^Fpa, Aa, Gd, Aa, Aa, Gs, Gll^Fp, Gd, Gd, Aa, Hhd, Hhd, Hhd, Gd, Gd, Gd, Aa, Aa, Hhd, Hhd, Aa, Gd, Aa, Aa, Aa, Gd^Ve, Gd, Gd, Ai, Ai, Ai, Ai, Ai, Ai, Ai, Ai, Ai, Ai, Ai, Ai, Ha^Fpa, Ha, Ha^Fma, Ha, Ms, Ms, Ms^Xm, Ms^Xm, Ms^Xm, Ms^Xm
Ms, Ha^Fpa, Ha^Fpa, Ha^Fpa, Ha, Ha, Ms^Xm, Ha, Ms^Xm, Ha^Vca, Aa, Ha, Ha^Fpa, Aa, Aa, Aa, Gd, Gd, Gd, Gd, Gll^Fp, Gd, Hhd, Hhd, Aa, Aa, Aa, Gd, Aa, Gd, Gd, Gd, Aa, Aa, Aa^Fma, Aa^Fma, Ai, Ai, Ai, Ai, Gd, Aa, Cv, Cv, Cv, Gd, Gd, Gd^Fpa, Gd^Fpa, Gd, Ha, Ha^Fpa, Aa^Fma, Aa^Fma, Ha, Ms, Ms, Ms, Ms^Xm, Ms^Xm, Ms^Xm, Ms^Xm
Ms, Ms, Ha, Ha, Ms, Ms^Xm, Ms^Xm, Ms^Xm, Ms^Xm, Ms^Xm, Ms^Xm, Aa, Ha, Ha^Fpa, Ha^Fpa, Aa, Aa, Aa, Gd, Gd, Aa, Gd, Aa, Gd, Aa^Fpa, Aa, Gd, Gd, Aa, Aa, Gd, Aa, Aa, Aa, Gd, Ai, Ai, Ai, Ai, Aa, Gd^Fpa, Gd, Cv, Cv, 2 Kv, Cv, Cv, Gd^Fpa, Gd^Fpa, Gd^Fpa, Ha, Ha^Fpa, Ha, Ha, Ms, Ms, Ha, Ms, Ms, Ms^Xm, Ms^Xm, Ms^Xm
Ms, Ms, Ms, Ms, Ms, Ms^Xm, Ms^Xm, Ms^Xm, Ms^Xm, Ms^Xm, Ha, Ms^Xm, Ms, Aa, Ha, Ha^Fma, Aa, Aa, Gd, Gd, Gd^Ve, Aa, Aa^Fpa, Aa^Fpa, Gd, Aa, Gd, Gll^Fp, Gll^Fp, Gd, Gd, Aa, Gd^Fpa, Aa^Fpa, Ai, Ai, Ai, Ai, Aa, Aa, Gd^Fpa, Gd^Fpa, Gd, Cv, Cv, Cv, Cv, Gd, Gd, Gd, Aa, Aa, Aa^Ve, Ha, Ha, Ha^Fpa, Ha^Fpa, Ms, Ha^Fma, Ms^Xm, Ha, Ms^Xm
Ms^Xm, Ms, Ms, Ms, Ms, Ms, Ms, Ms^Xm, Ha^Fma, Ha, Ms^Xm, Ms^Xm, Ms, Ha, Ha, Ha, Aa^Fpa, Aa, Gs^Fp, Gs^Fp, Ai, Ai, Aa^Fpa, Aa, Aa, Aa, Gd, Gll^Fp, Gll^Fp, Gs, Gs, Gd, Gd^Ve, Aa^Fpa, Aa, Ai, Gd, Aa, Aa, Aa, Aa, Gd, Aa^Fma, Gd, Gd, Cv, Gd, Hhd, Hhd, Hhd, Aa, Aa, Aa, Ha, Ha, Aa, Ha, Ha^Fpa, Ms, Ms, Ha^Fpa, Ms
Ms^Xm, Ms, Ms, Ms, Ms, Ms, Ms, Ha, Ha^Fma, Ha, Ha, Ms^Xm, Ms, Ms, Ha, Aa, Aa, Aa, Aa, Ai, Ai, Ai, Aa, Gd, Aa^Fma, Aa, Gd, Gll^Fp, Gd, Gd, Gs, Aa, Gd, Gd, Aa, Gd^Fma, Gd^Fma, Aa^Fma, Gd, Aa, Aa, Gd, Gd^Fma, Gd, Gd^Fma, Gd, Gd, Hhd, Gd, Gd, Gll^Fmw, Aa, Aa, Aa^Fpa, Gll^Fmw, Ha, Ha, Ms, Ms, Ms, Ha, Ms
Ms^Xm, Ms^Xm, Ms^Xm, Ha, Ha, Ms, Ms, Ha, Aa, Ms, Ha, Ha, Ha, Aa, Ha, Aa, Aa, Aa^Fma, Gll^Fp, Ai, Ai, Ai, Aa, Gd, Aa, Aa, Aa^Fpa, Aa^Fpa, Aa^Fpa, Gs^Fma, Gs, Gd, Aa, Gd, Gll^Fp, Gd^Fpa, Gd^Fpa, Gd, Gd, Hhd, Gd, Gd, Gd, Gd^Fma, Gd, Gd, Aa, Gd, Aa, Aa^Fma, Aa^Fma, Gll^Fmw, Gll^Fmw, Aa^Fma, Aa, Aa^Fpa, Aa, Ha, Ha^Fma, Ha, Ha, Ms
Ms^Xm, Ms^Xm, Ms^Xm, Ms, Ha, Ha, Ms, Ha, Ha, Ha, Ha, Ha^Fpa, Ha, Ha, Ha, Aa^Fma, Ha, Aa, Ai, Ai, Aa^Fma, Aa, Gll^Fmw, Gll^Fp, Aa, Gd^Fpa, Gd^Fma, Gd^Fpa, Aa^Fma, Gs^Fma, Aa^Fma, Gd, Aa, Gll^Fp, Hhd^Fp, Ss, Wwg, Aa, Aa, Hhd, Gd, Hhd, Aa, Gd, Aa^Fpa, Gs, Wwg, Wwg, Aa^Fma, Aa^Fma, Aa^Fpa, Ha^Fpa, Ha, Aa, Gll^Fmw, Aa, Aa, Ha, Ha^Fpa, Ha, Aa, Aa
Ms^Xm, Ms^Xm, Ms^Xm, Ms, Ms, Ms, Ms, Aa, Ha, Ha, Ha, Ha, Ha^Fma, Ha^Fma, Ha, Ha, Ai, Ai, Aa, Aa^Fma, Aa^Fma, Aa, Aa, Gll^Fmw, Aa, Gd, Gd, Gd^Fpa, Gd^Ve, Aa, Aa^Fma, Gll^Fp, Gll^Fp, Hhd^Fp, Wwg, Wwg, Aa, Aa, Gd, Aa^Fma, Aa^Fma, Aa^Fma, Aa^Fma, Aa^Fma, Aa^Fma, Aa^Fma, Aa^Fpa, Aa, Aa^Fma, Aa, Aa^Fpa, Gll^Fp, Ha^Fma, Aa, Aa, Gll^Fmw, Aa^Fpa, Aa, Aa, Aa, Ha^Fma, Aa
Ms^Xm, Ms^Xm, Ms, Ms, Ms, Ms, Ha, Ha, Ha^Fpa, Ha^Fpa, Ha, Ha^Fma, Ha^Fma, Ha, Ha, Ha, Ai, Aa^Vca, Ha, Aa^Fma, Ha, Aa, Ha, Aa, Gll^Fmw, Gd, Aa, Aa, Gll^Fp, Aa, Aa, Gd, Gd, Gll^Fp, Aa^Fpa, Wwg, Aa^Fpa, Aa^Fma, Gd, Aa^Fma, Aa^Fpa, Aa^Fma, Gll^Fp, Aa, Aa^Fma, Gs, Aa^Fma, Aa^Fpa, Aa, Aa^Fma, Aa^Fma, Gll^Fp, Gll^Fp, Gll^Fmw, Aa, Aa^Fma, Hhd^Fp, Aa^Fma, Aa^Fma, Hhd^Fma, Ha, Aa
Ms^Xm, Ms^Xm, Ms, Ms, Ms, Ms, Ha, Ha, Ha, Ha^Fpa, Ha, Ha, Ha, Ha, Ms, Ha, Ai, Ms, Ms, Ha, Ha, Ha^Fma, Aa, Aa, Gd, Aa, Gd, Aa^Fpa, Gd, Gd, Hhd^Fp, Hhd, Aa^Fma, Aa^Fpa, Aa, Aa^Fpa, Gll^Fp, Gll^Fp, Aa^Fpa, Aa, Gll^Ve, Aa^Fma, Gs, Aa, Aa^Fma, Aa^Fpa, Aa^Fpa, Aa, Gll^Fp, Aa^Fma, Aa^Fma, Gll^Ve, Aa^Fma, Aa^Fma, Gll^Fmw, Aa, Aa, Hhd^Fp, Aa, Hhd^Fma, Ha^Fpa, Aa
Ms^Xm, Ms^Xm, Ms, Ms, Ms, Ms, Ha, Ha^Vca, Ha, Ha, Ms, Ha, Ms, Ms, Ms, Ms, Ai, Ms, Ha, Ms, Ha, Ha^Fma, Ha^Fma, Aa, Gd, Gd^Fma, Gll^Fp, Gll^Fmw, Gll^Fmw, Aa, Hhd^Fp, Hhd^Fp, Aa^Fpa, Gll^Fmw, Aa^Fma, Aa, Aa^Fma, Aa^Fpa, Aa^Fma, Gll^Fp, Aa, Gs, Aa^Fma, Aa^Fma, Aa^Fpa, Aa^Fpa, Aa^Fpa, Gll^Fp, Aa^Fma, Aa^Fpa, Aa^Fpa, Aa^Fma, Aa^Fpa, Aa^Fpa, Aa^Fma, Aa^Fpa, Gll^Fp, Aa^Fpa, Aa^Fpa, Hhd^Fmw, Aa, Aa
Ms^Xm, Ms^Xm, Ha, Ha^Fpa, Ha^Fpa, Ha, Ha, Ha, Ms, Ms, Ms, Ms, Ms, Ms, Ai, Ai, Ms, Ha, Ms, Ha, Ha, Ha^Fma, Ha^Fpa, Aa^Fpa, Aa, Aa^Fma, Aa^Fma, Gll^Fp, Gll^Fp, Gll^Fp, Gd, Aa^Fma, Gll^Fmw, Gll^Fmw, Aa^Fma, Aa^Fma, Aa^Fma, Aa^Fma, Aa^Fma, Aa^Fma, Aa^Fma, Gs, Gs, Gll^Fp, Gll^Fp, Aa^Fpa, Gll^Fmw, Aa^Fma, Aa^Fma, Aa, Aa^Fma, Aa^Fpa, Aa^Fma, Gll^Fmw, Aa^Fma, Aa^Fpa, Aa^Fpa, Gll^Fp, Aa^Fpa, Aa, Aa^Fma, Aa
Ms^Xm, Ms^Xm, Ha, Ha^Fpa, Ha, Ms, Ms, Ms, Ms, Ms, Ms, Ms, Ms, Ms, Ms, Ms, Ms^Xm, Ms, Ms^Xm, Ha, Ms^Xm, Ha, Ha, Ha^Fpa, Ha, Aa, Aa^Fma, Gd^Fma, Gll^Fmw, Gll^Fmw, Aa^Fpa, Aa^Fpa, Aa^Fma, Aa^Fpa, Aa^Fma, Aa, Aa^Fma, Aa^Fma, Aa^Fma, Hhd^Fma, Hhd, Aa^Fma, Gs, Aa^Fma, Aa^Fma, Aa^Fma, Aa^Fma, Aa^Fma, Aa^Fma, Aa^Fma, Aa, Aa, Aa^Fpa, Aa^Fma, Aa^Fpa, Aa^Fpa, Aa, Aa^Fma, Aa, Aa^Fpa, Aa^Fma, Gs
Ms^Xm, Ms^Xm, Ha, Ha, Ms, Ms, Ms, Ms, Ms, Ms, Ms^Xm, Ms, Ms^Xm, Ms^Xm, Ms^Xm, Ms^Xm, Ms^Xm, Ms^Xm, Ms^Xm, Ms^Xm, Ms^Xm, Ms^Xm, Aa, Ha, Ha, Aa, Aa, Aa, Gd, Gd, Gd, Aa^Fpa, Gd, Hhd, Gd, Aa, Gd, Aa^Fma, Aa^Fma, Hhd, Aa^Fma, Aa^Fma, Gd, Aa^Fma, Gd, Aa^Fma, Gd, Aa^Fma, Aa^Fma, Gll^Fmw, Gd, Aa, Aa, Aa^Fpa, Aa^Fpa, Aa^Fpa, Aa^Fpa, Aa^Fma, Aa^Fma, Aa^Fma, Gs, Gs
