border_size=1
usage=map

Xu, Xu, Wwf, Uu, Uu, Xu, Xu, Xu, Xu, Xu, Xu, Xu, Xu, Ss, Ss, Wwg, Sm, Sm, Xu, Xu, Xu, Xu, Xu, Ss, Ss, Ss, Ss, Sm, Sm, Ss, Ss, Ss, Ss, Ss, Ss, Xu, Xu, Xu, Xu, Xu
Xu, Xu, Xu, Wwf, Wwg, Uh, Uh, Xu, Xu, Xu, Xu, Xu, Xu, Ss, Wwg, Wwg, Wwg, Sm, Uu, Uu^Uf, Uu, Uh, Ss, Ss, Uh, Ss, Sm, Sm, Sm, Ss, Sm, Ss, Xu, Ss, Xu, Xu, Xu, Xu, Ur, Ur
Xu, Xu, Xu, Wwf, Wwf, Uu^Vud, Uu, Xu, Xu, Xu, Xu, Xu, Xu, Ss^Vhs, Wog, Wwg, Wog, Wog, Wwg^Bw/r, Uu, Xu, Uu, Uu, Uh, Uu^Vud, Uh, Uu, Sm, Wwf, Sm, Uu^Uf, Xu, Xu, Xu, Xu, Xu, Ur, Ur, Ur^Br/, Ur^Br/
Xu, Xu, Xu, Xu, Wwf, Wwf, Wwf, Wwf, Wwf, Uu^Uf, Uh, Xu, Xu, Xu, Xu, Wog, Wog^Bw/r, Wog^Bw/r, Wwg, Xu, Xu, Xu, Uu, Uu, Wwf, Wwf, Wwf, Wwf, Wwf, Wwf, Uu, Uh, Ur^Br/, Xu, Xu, Xu, Ur^Br/, Ur^Br/, Ur, Ur
Xu, Xu, Xu, Ss, Wwf, Wwg, Uu, Wwf, Wwf, Wwf, Wwf, Wwf, Wwg, Xu, Wwg, Wog, Wwg^Bw|r, Wog, Wog, Ss, Xu, Xu, Wwf, Wwf, Wwg, Wwg, Uu, Wwf, Cud, Cud, Cud, Ur^Br/, Ur, Ur^Br\, Ur^Br/, Ur^Br/, Ur, Ur, Xu, Xu
Xu, Xu, Uu, Wwf, Uh, Uu, Xu, Xu, Xu, Uu, Xu, Uu, Uu, Wwg, Uu, Wwg, Wog^Bw|r, Wwg, Wog, Ss, Wog^Vm, Xu, Wwf, Wwg, Wwf, Wwf, Wwf, Cud, Cud, 4 Kud, Cud, Cud, Wwf, Ur, Uh, Ur, Uh^Uf, Ur, Xu, Xu
Xu, Xu, Uu^Uf, Wwf, Uu, Xu, Xu, Xu, 5 Uu, Xu, Xu, Uu, Uu, Xu, Wwf, Uu, Uu, Wog, Wog, Wwg, Wwg, Wwf, Wwg, Wwf, Ss, Wwf, Uu, Cud, Cud, Cud, Cud, Cud, Wwf, Uu^Vud, Uh^Uf, Uh, Xu, Xu, Xu, Xu
Xu, Xu, Ss, Wwf, Uu^Vud, Xu, Xu, Xu, Uh, Uu, Uu, Xu, Uu, Xu, Xu, Uu, Wwf, Xu, Wog, Wwg, Wwg, Wwg, Sm, Ss, Xu, Xu, Uu^Vud, Uu, Uu, Uu, Uu, Wwf, Wwf, Uu, Xu, Xu, Xu, Xu, Wwf, Wwf
Xu, Xu, Xu, Wwf, Wwf, Wwf, Uu, Xu, Uu, Uh, Uu, Uu, Uh^Uf, Xu, Xu, Uh, Wwf, Uu, Wog, Wwg, Wwg, Wwg, Ss^Bw/r, Uu, Uu, Xu, Uu, Uu, Uh, Uu, Xu, Uu, Wwf, Wwf, Wwf, Xu, Wwf, Wwf, Uu, Uu
Xu, Xu, Xu, Xu, Xu, Wwf, Wwf, Xu, Xu, Uu, Xu, Uu, Xu, Xu, Uu^Vud, Uu, Uu, Uh, Uu, Wwg, Wwg^Bw/r, Wwg^Bw/r, Wog, Ss, Wog, Uu, Wwf, Wwf, Wwf, Xu, Xu, Xu, Wwf, Wwf, Uu^Vud, Wwf, Uu, Uu, Uu, Uu
Xu, Uh, Uh, Xu, Xu, Wwf, Wwf, Wwf, Uu, Xu, Uu^Uf, Xu, Wwf, Uu, Uu, Uu, Xu, Xu, Wwf, Wwg^Bw\r, Xu, Wog, Wog, Wog, Wwf, Wwf, Wwf, Wwf, Wwf, Xu, Wwf, Wwf, Wwg, Wwf, Wwf, Uu, Xu, Uu^Uf, Xu, Uu
Xu, Uh, Wwf, Xu, Xu, Xu, Xu, Wwf, Uu, Uu, Uu, Uu, Uu, Wwf, Uh, Xu, Xu, Xu, Wwf, Wwf, Xu, Xu, Wwf, Wwf, Ss^Uf, Wwg, Ss, Wwg, Wwg, Wwf, Wwg, Wwf, Xu, Wwf, Wwg, Uu, Xu, Xu, Xu, Xu
Xu, Uu^Vud, Uu, Uu, Uu, Xu, Uu, Wwf, Xu, Xu, Xu, Uu, Xu, Uu, Uh, Uu, Wwf, Wwf, Wwf, Uu^Uf, Uu, Uu, Wwf, Wwf, Wwg, Wwg, Wog, Wwf, Uu, Uh^Uf, Xu, Xu, Wwf, Wwf, Uu, Uu, Uh, Xu, Xu, Xu
Xu, Uh, Uu, Wwf, Wwf, Wwf, Uu, Uu, Xu, Xu, Xu, Xu, Xu, Xu, Xu, Wwg, Wwf, Wwf, Uu, Wwf, Uu, Wwf, Uu, Wog, Wog, Wwg, Ss, Uu, Uu^Vud, Uu, Uu, Uh, Wwf, Wwg, Wwf, Uh, Wwf, Uu^Uf, Uu^Uf, Xu
Ss, Xu, Xu, Uu, Wwf, Wwf, Xu, Wwf, Wwf, Xu, Xu, Xu, Xu, Xu, Wwf, Wwf, Wwf, Wwf, Cud, Uu, Uu, Uu^Vud, Xu, Wog, Wog, Wog, Ss^Uf, Xu, Xu, Uu, Wwf, Uu, Uu, Wwf, Wwf, Wwf, Wwg, Wwf, Wwf, Uu
Ss, Xu, Xu, Xu, Uu, Wwf, Xu, Uu, Xu, Wwf, Uu, Xu, Xu, Wwf, Wwf, Wwf, Uu^Uf, Uu, Cud, 2 Kud, Cud, Uu, Xu, Wog, Wwg, Wwg, Wog^Vm, Xu, Xu, Xu, Uu, Uu, Xu, Xu, Xu, Uu, Wwf, Wwf, Uu^Vud, Uu
Wwf, Ss, Wwg, Xu, Xu, Wwf, Wwf, Xu, Xu, Uu, Uu^Vud, Uh, Xu, Xu, Wwg, Wwf, Uu^Uf, Uu, Ss, Cud, Uu, Wwf, Wog, Wog, Wwg, Wwg, Wwg, Xu, Uu, Uu, Wwf, Uu^Uf, Xu, Xu, Xu, Xu, Wwf, Wwf, Uu, Uu
Xu, Wwf, Wwf, Xu, Xu, Uu, Uu, Uu, Uu, Wwf, Uu, Uu, Xu, Xu, Wwf, Wwf, Ss^Vhs, Ss, Uu, Uu, Wwf, Uu, Wwg^Bw\r, Wwg, Wwg^Bw/r, Wwg, Wog, Ss, Ss, Uh, Uu, Uu, Xu, Xu, Xu, Wwf, Wwf, Uu, Uh^Uf, Uu
Xu, Xu, Wwf, Wwf, Xu, Xu, Xu, Xu, Uh, Wwf, Xu, Xu, Wwf, Wwg, Wwf, Wwg, Uu, Uu, Xu, Uu, Xu, Wog, Wog, Wwg^Bw\r, Wog, Wog^Bw\r, Uu, Ss, Ss, Wwf, Wwf, Wwf, Wwf, Wwg, Wwf, Wwf, Uu, Uh, Xu, Xu
Xu, Xu, Xu, Wwf, Wwf, Xu, Xu, Xu, Uu, Uu, Wwf, Wwf, Wwf, Wwf, Xu, Xu, Uu, Uh, Xu, Xu, Ss, Wog, Wwg, Wog, Ss, Uu^Uf, Xu, Xu, Uu, Wwf, Wwf, Wwg, Xu, Wwf, Wwf, Uu, Uh, Uu, Xu, Xu
Xu, Xu, Xu, Ss, Ss, Wwf, Wwf, Wwg, Wwf, Wwf, Wwf, Wwf, Xu, Xu, Xu, Uh, Uu, Uu, Xu, Xu, Ss, Wwg, Wwg, Ss, Sm, Sm, Xu, Xu, Uh, Wwg, Ww^Vm, Xu, Xu, Wwf, Wwf, Uu, Xu, Xu, Xu, Xu
Xu, Xu, Xu, Xu, Xu, Wwf, Wwg, Wwf, Wwg, Xu, Xu, Xu, Xu, Xu, Xu, Uh, Uu, Xu, Xu, Ss, Wwg, Wwg, Wwg, Ss, Xu, Xu, Xu, Uh, Wwg, Wwf, Xu, Xu, Xu, Uu, Wwf, Uu^Vud, Xu, Xu, Xu, Xu
Xu, Xu, Uu, Uu, Uu, Xu, Xu, Wwg, Uu, Wwf, Wwf, Xu, Wwf, Uu, Uu, Uu, Uu, Uu^Vud, Xu, Sm^Uf, Wog, Wog, Wwg, Sm, Xu, Xu, Uu, Uu, Wwf, Wwf, Xu, Xu, Xu, Uu, Wwf, Uh, Uh, Xu, Xu, Xu
Xu, Uh, Uu, Uh, Uu, Uu, Uu, Uu, Uu, Wwg, Wwf, Wwf, Wwf, Wwf, Wwf, Uu, Ss, Xu, Xu, Sm^Uf, Wog, Wog, Wog, Ss, Sm, Wwf, Wwf, Wwf, Wwg, Wwf, Wwf, Xu, Wwg, Wwf, Wwf, Wwf, Uu^Uf, Xu, Xu, Xu
Xu, Uu^Vu, Uu, Uu, Xu, Xu, Xu, Uu^Vu, Uu, Uh, Uu, Wwf, Ss, Xu, Xu, Wwf, Wwf, Ss, Wwg, Wog, Wog, Wwg, Wog, Sm, Uu, Uu, Uh, Uu, Uu, Wwg, Wwf, Wwf, Wwf, Ss, Ss, Wwg, Uu, Uu, Xu, Xu
Xu, Uh, Xu, Xu, Xu, Xu, Uu^Uf, Uu, Uu, Uh, Uu, Ss, Ss, Xu, Xu, Xu, Uu, Wwf, Wog, Wog, Wwg, Wwg, Wog^Bw/r, Uu, Uu, Uh, Ss, Uu, Wwf, Wwf, Uu^Vud, Wwf, Wwf, Ss, Wwf, Wwf, Wwf, Wwf, Uh, Xu
Xu, Xu, Xu, Xu, Xu, Uu^Uf, Co, Co, Co, Uu, Uu, Uu, Uu, Xu, Xu, Xu, Xu, Uu, Uu, Wwg, Wwg^Bw/r, Wog^Bw/r, Wog, Uu^Vud, Xu, Ss, Wwf, Ss, Wwf, Wwf, Xu, Uu, Wwf, Wwf, Wwf, Wwf, Wwf, Wwf, Ur^Vud, Ur
Xu, Xu, Xu, Xu, Uu, Uu, Co, Co, Co, Uu, Uu^Vu, Uu, Uh, Xu, Xu, Xu, Xu, Xu, Wwg, Wwg^Bw\r, Wwg, Wog, Ss, Uu^Uf, Xu, Xu, Wwf, Wwf, Wwf, Xu, Wwf, Uh, Cud, Cud, Cud, Uu, Uu^Br/, Ur, Ur, Ur
Xu, Xu, Xu, Uh, Uu, Co, 1 Ko, Co, Uu, Uu, Uh, Uu, Uh, Xu, Xu, Xu, Xu, Xu, Wog, Wog, Ss, Wog, Ss^Uf, Ss^Uf, Xu, Xu, Uu, Wwf, Wwf, Wwf, Wwf, Wwf, Cud, 3 Kud, Cud, Cud, Uu, Ur^Br\, Ur^Br\, Ur
Xu, Xu, Xu, Uh, Uu, Co, Co, Co, Uu, Uu, Uu, Uh, Xu, Xu, Xu, Xu, Wwg, Wog, Wog, Wwg, Ss, Ss, Xu, Ss^Uf, Xu, Xu, Uh, Wwf, Uh, Wwf, Uu, Wwf, Cud, Cud, Uu, Uu, Uh^Uf, Ur, Ur, Ur^Br/
Xu, Xu, Xu, Uu, Uu, Co, Uu, Uu, Uu, Uu, Xu, Xu, Xu, Xu, Ss, Wwg, Wwg, Wwg, Wog, Wog, Wog, Ss, Xu, Xu, Xu, Xu, Uh, Wwf, Wwf, Xu, Xu, Uu^Uf, Uu, Uh, Uh^Vud, Uu, Uu, Ur, Xu, Ur
Xu, Xu, Xu, Uu^Vu, Uu, Uu, Uu, Uu, Xu, Xu, Xu, Ss, Ss, Ss, Wwg, Wwg, Wog, Wog, Wog, Wog^Vm, Xu, Xu, Xu, Xu, Xu, Xu, Wwf, Wwg, Wwf, Xu, Xu, Xu, Xu, Uh, Uh, Uh, Xu, Xu, Xu, Xu
Xu, Xu, Xu, Uu, Uu, Uu, Xu, Xu, Xu, Xu, Xu, Ss, Wog, Ss, Wog, Wog, Wog, Wog, Uu, Xu, Uu, Xu, Wwg, Xu, Xu, Wwf, Wwg, Wwf, Wwf, Xu, Uu, Xu, Xu, Xu, Xu, Xu, Xu, Xu, Xu, Xu
