border_size=1
usage=map

Ww, Ss, Ss, Ss, Ss, Gg, Gg, Gg, Gg, Gg, Gg, Gg, Gg, Gg, Gg, Gg, Gg, Gg, Gg, Gg, Hh, Hh, Mm, Mm, Mm, Mm, Mm^Xm, Mm^Xm, Mm^Xm, Mm^Xm, Mm^Xm, Mm^Xm, Mm^Xm, Mm^Xm, Mm, Mm, Mm, Mm, Hh, Gg, Gg, Gg, Gg, Gg, Mm, Mm, Mm^Xm, Mm^Xm, Mm^Xm, Mm^Xm, Mm^Xm, Mm^Xm, Mm^Xm, Mm^Xm, Mm^Xm, Mm^Xm, Mm^Xm, Mm^Xm
Ww, Ww, Ss, Ss, Ss, Ss, Gg, Gg, Gg, Gg, Gg^Fms, Gg, Gs, Gg^Fp, Gg^Fms, Gg^Fp, Gg^Fp, Gg, Gg, Hh, Hh^Fms, Hh, Hh, Mm, Mm, Mm, Mm^Xm, Mm^Xm, Mm^Xm, Mm^Xm, Mm^Xm, Mm^Xm, Mm^Xm, Mm^Xm, Mm^Xm, Mm, Hh, Mm, Hh, Hh, Gs, Gs, Gg, Hh, Mm, Mm, Mm, Mm^Xm, Mm^Xm, Mm^Xm, Mm^Xm, Mm^Xm, Mm, Mm, Mm^Xm, Mm^Xm, Mm^Xm, Mm^Xm
Ww, Ww, Ss, Ss, Ss, Ss, Ss, Gg, Gg, Gs, Gs, Gg^Fms, Gg^Fp, Gg^Fp, Gg^Fp, Gg, Gs, Gs, Gg^Fms, Hh^Fms, Hh^Fms, Hh, Gg, Mm, Mm, Mm, Mm, Mm^Xm, Mm, Mm^Xm, Mm^Xm, Mm^Xm, Mm, Mm^Xm, Mm, Mm, Gg, Hh, Gg, Gg, Gg, Gg, Gg^Fp, Hh, Mm, Mm, Hh, Mm^Xm, Mm^Xm, Mm^Xm, Mm^Xm, Mm, Mm^Xm, Mm^Xm, Mm^Xm, Mm^Xm, Mm^Xm, Mm^Xm
Wo, Wo, Ww, Ss, Ww, Wo, Wo, Gg, Gg, Gs, Gg^Fms, Gs, Gg^Fp, Gg, Gg, Gg^Fp, Gg, Gs, Gg^Fms, Gg, Hh^Fms, Hh^Fms, Hh^Fms, Hh, Gg, Mm, Mm, Mm, Mm, Mm, Hh, Mm, Mm, Mm, Mm, Mm, Gg, Hh, Gg, Gg^Ve, Gs, Gg^Fp, Gg^Fp, Hh, Hh, Hh, Mm, Hh, Mm, Mm^Xm, Mm, Mm, Mm^Xm, Mm^Xm, Mm^Xm, Mm^Xm, Mm^Xm, Mm^Xm
Wo, Wo, Wo, Ww, Wo, Wo, Wo, Gg, Gg, Gs, Gg^Fms, Gg^Fms, Gg^Fp, Gg^Fp, Gg^Ve, Gg^Fms, Gg^Fms, Gg^Fms, Gs, Gg^Fms, Gg^Fms, Hh^Fms, Hh, Hh, Hh, Gg, Hh, Hh, Gg, Hh, Hh^Fp, Mm, Mm, Mm, Hh, Mm, Gg, Hh, Gs, Gs, Gg^Fp, Gg^Fp, Hh, Hh, Mm, Hh, Mm, Mm, Mm, Mm^Xm, Mm^Xm, Mm^Xm, Mm^Xm, Mm^Xm, Mm^Xm, Mm^Xm, Mm^Xm, Mm^Xm
Wo, Wo, Wo, Wo, Ww, Wo, Wo, Wo, Gg, Gs, Gs, Gg, Gs, Gg^Fp, Gg, Gg^Fp, Gg^Fms, Gg^Fms, Gs, Gs, Gs, Gg, Gg, Hh^Fms, Hh^Fp, Hh^Fp, Hh^Fp, Hh, Hh, Hh^Fp, Hh, Hh, Gg, Hh, Hh, Hh, Gs, Gg, Gs, Gs, Gg^Fms, Hh^Fp, Gg, Mm, Hh^Fms, Mm, Mm, Mm, Mm, Mm^Xm, Mm, Mm^Xm, Mm, Mm^Xm, Mm, Mm^Xm, Mm, Mm
Wo, Wo, Wo, Wo, Ww, Ww, Wo, Wo, Ds, Gg, Gg, Gs, Gs, Gg, Gg, Gg, Gg, Gg, Gg, Gg, Gg, Gs, Gs, Gg, Gg, Hh, Gg, Gg, Gg^Fms, Hh^Fp, Gg^Fms, Gg, Gg, Gg, Gg, Gg, Gs, Gg, Gg^Fms, Gg^Fms, Gg, Hh, Hh^Fms, Hh, Hh, Hh^Fms, Gg^Fms, Mm, Hh, Hh, Mm, Mm, Hh^Fms, Hh^Fms, Hh^Fms, Mm, Mm, Gg
Wo, Wo, Wo, Wo, Ww, Ww, Ww, Ds, Ds, Gg, Gg, Gs, Gg, Gg, Gg, Gg, Co, Co, Co, Co, Co, Gg, Gg, Gg, Gs, Gg, Gg^Ve, Gg, Gg^Fms, Gg^Fms, Gg, Gg^Fms, Gg^Fms, Gg, Gs, Gs, Gg^Fms, Gg^Fms, Gg, Gg^Fms, Gg^Fms, Gg, Hh^Fms, Mm, Gg, Hh, Gg, Hh^Fms, Hh, Mm, Hh^Fms, Mm, Mm, Hh, Mm, Mm, Mm, Mm
Wo, Wo, Wo, Ww^Vm, Wo, Wo, Wo, Ww, Ww, Ds, Ds, Ds, Ds, Gg, Gg, Co, Co, Co, 1 Ko, Co, Co, Co, Gg, Gg, Gg, Gg, Gg, Gg, Gg^Fms, Gg, Gs, Gg, Gs, Gs, Gg, Gg, Gg^Fms, Gg^Fms, Gs, Gg, Gg, Gg^Fms, Gg^Fms, Hh, Hh^Fms, Gg^Ve, Hh^Fms, Gg^Fms, Hh, Hh^Fms, Hh, Gg^Fms, Hh^Fms, Mm, Mm, Mm, Hh, Gg
Wo, Wo, Wo, Wo, Wo, Wo, Ww, Ww, Ww, Ww, Ww, Ds, Ds, Ds, Ds, Co, Co, Co, Co, Co, Co, Co, Gg, Gg, Gg, Gg^Fms, Gg, Gg, Gg^Fms, Gg^Fms, Gs, Gs, Gs, Gg, Gg^Fms, Gg, Gg^Ve, Gg, Gg, Gg, Gg, Gg^Fms, Gg^Fms, Gg, Gg, Gg^Fms, Gs, Hh, Gg, Gg^Fms, Hh^Fms, Mm, Hh, Hh, Gg, Mm, Mm, Mm
Wo, Wo, Wo, Wo, Ww, Wo, Ww, Ww, Wo, Ww, Ww, Ds, Ww, Ds, Ds, Co, Co, Co, Co, Co, Co, Co, Gg, Gg, Gg, Gg, Gg, Gg^Fms, Gg^Fms, Gg^Fms, Gs, Gg^Ve, Gs, Gs, Gg, Gg, Gg, Gg, Gg, Gg^Fms, Gg^Fms, Gg^Fms, Gg^Fms, Gg^Fms, Gg, Gg^Fms, Gs, Gg, Gg, Gg^Fms, Gg, Hh, Gg^Fms, Hh, Hh^Fms, Hh, Hh, Gg
Wo, Wo, Wo, Ds, Ds, Wo, Wo, Wo, Wo, Wo, Wo, Ww, Ww, Ww, Ds, Ds, Ds, Co, Ds, Co, Gg, Gg, Gg, Gg, Gg, Gg, Gg^Fms, Gg^Fms, Gs, Gg^Fms, Gg^Fms, Gs, Gg^Fp, Gg^Fp, Gg, Gg, Gg^Fms, Gg, Gg, Gs, Gs, Gs, Gs, Gg^Fms, Gg^Fms, Gg, Gs, Gg, Gg, Gg, Gg^Fms, Gg^Fms, Gg^Fms, Gg^Fms, Hh, Gg^Fms, Hh, Gg
Wo, Ww, Wo, Ds, Gg, Wo, Wo, Wo, Ww, Ww, Ww, Ww, Wo, Ww, Ww, Wo, Ds, Ds, Ds, Ds, Ds, Gg, Gg, Gg^Fms, Gg^Fms, Gg, Gg^Fms, Gs, Gg^Fp, Gg^Fp, Gg^Fms, Gg^Fms, Gg^Fp, Gg^Fp, Gg, Gg, Gg^Fms, Gg^Fms, Gg^Fms, Gg^Fp, Gg^Fms, Gg^Fms, Gg, Gg, Gg, Gg, Gg, Gs, Gs, Gs, Gs, Gs, Gg^Ve, Gg, Gs, Gg, Gs, Gg
Wo, Wo, Wo, Ds, Gg^Vc, Gg, Wo, Ww, Wo, Wo, Wo, Wo, Wo, Ww, Ww, Ww, Ww, Wo, Gg, Ds, Ds, Gg, Gg^Ve, Gg, Gs, Gs, Gg, Gg^Fp, Gg, Gg^Fms, Gg^Fms, Gg^Fp, Gg^Fp, Gg, Gg, Gg, Gg, Gg, Gg, Gg, Gg, Gg, Gg, Gg, Gg, Gg, Gg, Gg, Gg^Fp, Gg^Fp, Gg, Gs, Gs, Gs, Gs, Gs, Gg, Gg
Wo, Wo, Wo, Wo, Ww, Wo, Wo, Wo, Wo, Wo, Ww, Wo, Wo, Wo, Wo, Ww, Ww, Wo, Ww, Ds, Gg, Gg, Gg, Gs, Gg, Gs, Gg^Fms, Gg, Gg^Ve, Gg^Fms, Gg, Gg, Gg, Gg, Gg, Gg, Mm, Gg^Fms, Hh^Fms, Gg, Gg, Gg, Gg^Fms, Gg, Gg^Fms, Gg, Gg, Gg, Gg^Fp, Gg^Fms, Gg^Fms, Gg, Gg, Gg, Gg, Gg, Gg, Gg
Wo, Wo, Wo, Wo, Wo, Wo, Ww, Ww, Wo, Wo, Ww, Wo, Wo, Wo, Wo, Wo, Wo, Ww, Wo, Wo, Ww, Gg, Gg, Gg, Gg, Gg, Gg^Fms, Gs, Gs, Gs, Gg, Gg, Hh, Gg, Gg, Gg, Mm, Hh^Fms, Mm, Mm, Hh, Gg, Hh^Fms, Hh^Fms, Gg, Gg, Gg, Gg^Fp, Gg^Fp, Gg, Gg^Fms, Gg, Hh, Gg^Fms, Hh^Fms, Gg, Gg, Gg
Wo, Wo, Wo, Wo, Wo, Wo, Wo, Wo, Wo, Ww, Wo, Ww, Wo, Ww, Wo, Wo, Wo, Wo, Wo, Ww, Ww, Gg, Ss, Ss, Gg, Gg, Gg^Fms, Gs, Gg, Gg, Gg, Gg, Gg, Hh, Mm, Mm, Mm, Hh, Mm, Mm, Hh^Fms, Hh^Fms, Gg^Fms, Gg^Fms, Gg, Gg, Gg^Fp, Gg, Gg, Gg, Gg^Fms, Gg^Fms, Hh, Hh, Gg, Hh^Fms, Gg, Gg
Wo, Wo, Wo, Wo, Wo, Wo, Wo, Wo, Ww, Wo, Wo, Ww, Ww, Ww, Wo, Wo, Wo, Ww^Vm, Wo, Wo, Ww, Wo, Ss, Ss, Gg, Gg, Gg, Gg^Fms, Gg^Fms, Gg, Gg, Mm, Hh^Fms, Hh^Fms, Hh^Fms, Mm, Gg^Fp, Mm, Mm, Mm, Hh^Fms, Hh^Fms, Gg, Gg, Gg, Gg^Fp, Gg, Gg, Gg, Gg^Ve, Gg, Gg^Fms, Hh^Fms, Gg, Mm, Hh^Fms, Hh, Gg
Wo, Wo, Wo, Wo, Wo, Wo, Wo, Wo, Wo, Wo, Wo, Wo, Wo, Wo, Wo, Wo, Wo, Wo, Ww, Ww, Wo, Ww, Wo, Ss, Ss, Gg, Gg, Gg, Gg^Fms, Gg, Gg^Fms, Mm, Hh^Fms, Hh^Fms, Mm, Hh^Fms, Mm, Mm, Mm, Mm, Hh, Mm, Hh, Gg, Gg, Gg, Gg, Gg, Gg, Hh, Hh^Fms, Hh^Fms, Hh^Fms, Hh^Fms, Mm, Mm, Mm^Xm, Mm^Xm
Wo, Wo, Wo, Wo, Wo, Ww, Wo, Wo, Ds, Wo, Ww, Wo, Wo, Ww, Wo, Ww, Wo, Wo, Wo, Ww, Wo, Ww, Ww, Ss, Ss, Gg, Gg, Gg^Ve, Gg, Gg, Gg^Fms, Gg^Fms, Hh, Gg, Mm, Mm, Hh^Fms, Mm, Mm, Mm, Gg^Ve, Mm, Hh^Fms, Gg^Fms, Gg^Fms, Gg, Gg, Gg, Gg, Hh^Fms, Hh^Fms, Hh^Fms, Hh, Hh, Mm, Mm, Mm^Xm, Mm^Xm
Wo, Wo, Wo, Wo, Wo, Wo, Ds, Ds, Gg^Vc, Ds, Wo, Wo, Wo, Wo, Wo, Ww, Wo, Ww, Wo, Wo, Wo, Ww, Wo, Wo, Ss, Ss, Ss, Gg, Gg, Gg, Gg^Fms, Gg^Fms, Gg, Mm, Hh^Fms, Gg^Fms, Gg^Fms, Hh^Fms, Hh, Gg, Hh^Fms, Gg, Gg^Fms, Hh, Gg, Gg, Gg, Gg, Gg, Hh^Fms, Gg^Fms, Hh^Fms, Mm, Mm, Mm^Xm, Mm^Xm, Mm^Xm, Mm^Xm
Wo, Wo, Wo, Wo, Wo, Wo, Wo, Gg, Ds, Ds, Wo, Wo, Wo, Wo, Wo, Wo, Wo, Ww, Wo, Wo, Wo, Ww, Wo, Wo, Ss, Ss, Ss, Gg, Gg, Gg, Gg^Fms, Gg^Fms, Gg^Fms, Gg, Gg, Hh, Hh, Gg, Gg, Gg, Gg, Gg^Fms, Gg, Gg^Fms, Gg, Gg, Gg^Fms, Gg, Gg, Gg, Hh, Gg^Fms, Gg, Mm, Mm, Mm, Mm^Xm, Mm^Xm
Wo, Wo, Wo, Wo, Ww, Wo, Ww, Wo, Wo, Wo, Wo, Wo, Wo, Wo, Wo, Wo, Wo, Ww, Wo, Wo, Wo, Wo, Wo, Wo, Wo, Ss, Ss, Gg, Gg, Gg, Gg, Gg^Fp, Gg^Fms, Gg^Fms, Gs, Gg, Gs, Gg, Gg, Gg^Fms, Gg^Fms, Gg, Gg^Fms, Gg, Gg^Fp, Gg^Fms, Gg, Gg, Gg, Hh, Mm, Hh^Fms, Hh, Mm, Mm^Xm, Mm, Mm^Xm, Mm^Xm
Wo, Wo, Wo, Wo, Wo, Wo, Wo, Wo, Wo, Ww, Wo, Wo, Wo, Wo, Wo, Ww, Wo, Wo, Wo, Wo, Wo, Wo, Wo, Ww, Wo, Ss, Ss, Ss, Gg, Gg, Gs, Gs, Gg^Fms, Gs, Gg^Fms, Gs, Gg^Fms, Gs, Gg^Fms, Gg^Fms, Gg^Fms, Gg^Fms, Gg, Gg, Gg^Fp, Gg, Gg, Gg, Gg^Fms, Gg, Mm, Gg, Mm, Mm, Mm^Xm, Mm^Xm, Mm^Xm, Mm^Xm
Wo, Wo, Wo, Wo, Wo, Wo, Wo, Wo, Wo, Wo, Wo, Wo, Wo, Wo, Wo, Wo, Wo, Wo, Wo, Wo, Wo, Wo, Wo, Ww, Ww, Wo, Wo, Ss, Ds, Gg, Gg^Fms, Gg^Ve, Gg^Fms, Gg^Fms, Gg^Fms, Gg, Gg, Gg^Fms, Gs, Gs, Gg^Fp, Gg^Fp, Gg^Fp, Gg, Gg, Gg^Ve, Gg, Gg, Hh, Hh^Fms, Hh, Mm, Mm^Fms, Mm, Mm, Mm, Mm^Xm, Mm^Xm
Wo, Wo, Wo, Wo, Wo, Wo, Wo, Wo, Ww, Wo, Wo, Wo, Wo, Wo, Wo, Wo, Wo, Wo, Wo, Wo, Wo, Wo, Wo, Ww, Ww, Ww, Wo, Ds, Ds, Gg, Gg, Gg^Fms, Gg, Gg^Fms, Gg, Gg^Fms, Gg, Gg^Fms, Gg, Gg, Gg^Fp, Gg, Gg, Gll^Fp, Gll^Fp, Gll^Fp, Gll^Fp, Gg, Hh, Hh, Gg^Fms, Mm, Hh^Fms, Mm, Mm^Xm, Mm^Xm, Mm, Mm^Xm
Wo, Wo, Wo, Wo, Wo, Wo, Wo, Wo, Ww, Wo, Wo, Wo, Wo, Ww, Wo, Wo, Wo, Wo, Wo, Wo, Wo, Wo, Wo, Wo, Ww, Ww, Wo, Ds, Ds, Ds, Gg, Gg, Gg, Gg, Gg, Gg, Gs, Gll^Fp, Gs, Gg, Gg, Gs, Gs, Gg, Gll^Fp, Gll^Fp, Hh, Hh, Gll^Fp, Mm, Mm, Mm, Mm, Mm^Xm, Hh^Fms, Mm^Xm, Mm^Xm, Mm^Xm
Wo, Wo, Wo, Wo, Wo, Wo, Ww, Wo, Wo, Wo, Ww, Wo, Ww, Ww, Wo, Ds, Gg, Wo, Wo, Wo, Wo, Wo, Wo, Wo, Wo, Wo, Wo, Ds, Ds, Gg, Gg, Gg, Gg, Gg, Gg, Gll^Fp, Gg, Gll^Fp, Gll^Fp, Gll^Fp, Gll^Fp, Gll^Fp, Gg, Gg, Gll^Fp, Hh, Hh^Fp, Hh, Hh, Mm, Mm, Mm, Mm, Mm^Fms, Hh^Fms, Mm^Xm, Mm, Mm^Xm
Wo, Wo, Wo, Wo, Wo, Wo, Wo, Wo, Wo, Ww, Wo, Wo, Wo, Ww, Ww, Ds, Gg^Vc, Gg, Ds, Ds, Wo, Wo, Ww, Wo, Wo, Wo, Ds, Ds, Ds, Gg, Gg, Gg, Gg, Gg, Gll^Fp, Gs, Gg, Gg, Hh^Fp, Hh^Fp, Hh^Fp, Gg, Gs, Gg, Gll^Fp, Gll^Fp, Hh, Hh^Fp, Hh, Mm, Hh, Mm, Mm, Hh^Fms, Mm^Xm, Mm, Mm^Xm, Mm^Xm
Wo, Wo, Wo, Wo, Wo, Wo, Wo, Ww, Wo, Wo, Wo, Wo, Wo, Wo, Ww, Ds, Ds, Ds, Ds, Wo, Wo, Ww, Ww, Wo, Wo, Ds, Ds, Ds, Gg, Gg, Gg, Gg, Gg, Gll^Fp, Gg^Ve, Gs, Gg, Gll^Fp, Hh^Fp, Hh^Fp, Gs, Gll^Fp, Gs, Gll^Fp, Gs^Fms, Gll^Fp, Gll^Fp, Hh, Hh^Fms, Hh, Hh^Fms, Mm, Gll^Fp, Hh, Mm, Mm^Xm, Mm^Xm, Mm^Xm
Wo, Wo, Wo, Wo, Wo, Wo, Wo, Wo, Wo, Wo, Wo, Wo, Ww, Wo, Ww, Wo, Wo, Wo, Wo, Wo, Wo, Ww, Ww, Ww, Wo, Ds, Gg, Gg, Gg, Gg, Gll^Fp, Gll^Fp, Gg, Gg, Gll^Fp, Gs, Gg, Gll^Fp, Gll^Fp, Gll^Fp, Gll^Fp, Hh^Fp, Gll^Fp, Gs, Gs, Gs, Gll^Fp, Gll^Fms, Hh, Hh, Hh, Mm, Hh, Mm, Mm, Mm^Xm, Mm, Mm^Xm
Wo, Wo, Wo, Wo, Wo, Wo, Wo, Wo, Wo, Wo, Wo, Wo, Wo, Wo, Wo, Wo, Ww, Wo, Wo, Wo, Ww, Ww, Ww, Wo, Wo, Ds, Ds, Gg, Gg, Gg, Gll^Fp, Gll^Fp, Gll^Fp, Gg, Gll^Fp, Gg, Gg, Gll^Fp, Gs, Gs, Gs, Hh^Fp, Gs^Fms, Gs^Fms, Gg^Ve, Gll^Fp, Gg, Gg, Hh^Fp, Gll^Fp, Hh, Gll^Fp, Gll^Fp, Mm, Mm, Gll^Fp, Hh, Mm^Xm
Wo, Wo, Wo, Wo, Wo, Wo, Wo, Wo, Wo, Wo, Ww, Ww, Wo, Ww, Wo, Ww, Ww, Ww^Vm, Wo, Wo, Ww, Ww, Ds, Wo, Ds, Ds, Ds, Gg, Gg, Gg, Gll^Fp, Gg, Gs, Gs^Fms, Gs^Fms, Gll^Fp, Gg, Gg, Gll^Fp, Gll^Fp, Gll^Fp, Gll^Fp, Gs^Fms, Gs^Fms, Gs, Gg, Gll^Fp, Gg, Gll^Fp, Hh^Fp, Gll^Fp, Hh, Hh, Gll^Fp, Hh, Hh, Hh, Hh
Wo, Wo, Wo, Wo, Wo, Wo, Wo, Wo, Wo, Wo, Ww, Wo, Ww, Wo, Wo, Wo, Ww, Wo, Wo, Wo, Ww, Ww, Ds, Ds, Ds, Ds, Gg, Gg, Gll^Fp, Gg, Gg, Gg, Gs, Gs^Fms, Gs, Gg, Gll^Fp, Gg, Gg, Gg, Gll^Fp, Gg^Fet, Gll^Fp, Gs^Fms, Gll^Fp, Gll^Fp, Gg, Gg, Gs, Gll^Fp, Gll^Fp, Hh^Fp, Hh^Fp, Hh, Gll^Fp, Hh^Fms, Gll^Fms, Gll^Fp
Wo, Wo, Wo, Wo, Wo, Wo, Wo, Wo, Wo, Wo, Ww, Wo, Wo, Ww, Ww, Ww, Wo, Wo, Ww, Ww, Ww, Ww, Ds, Ds, Ds, Gg, Gll^Fp, Gg^Ve, Gg, Gg, Gll^Fp, Gll^Fp, Hh^Fp, Hh^Fp, Gll^Fp, Gll^Fp, Hh^Fp, Gg, Gg, Gll^Fms, Gll^Fms, Gll^Fp, Gll^Fp, Gll^Fp, Gs, Gll^Fp, Gll^Fp, Gll^Fp, Gs, Gll^Fp, Gll^Fp, Gll^Fp, Gll^Fp, Gg, Gll^Fp, Gll^Fp, Gll^Fp, Gll^Fp
Wo, Wo, Wo, Wo, Wo, Wo, Wo, Wo, Wo, Wo, Wo, Wo, Wo, Wo, Ww, Ww, Wo, Ww, Wo, Wo, Ww, Ds, Ds, Gg, Gg, Ds, Gll^Fp, Gll^Fp, Gg, Gll^Fp, Gs, Gs, Gll^Fp, Hh^Fp, Gll^Fp, Gll^Fp, Gll^Fp, Hh^Fp, Gs, Gll^Fp, Gll^Fms, Gll^Fp, Gll^Fp, Gg, Gg, Gs, Gs, Gs, Gll^Fp, Gg, Gll^Fp, Gg^Ve, Gg, Gg, Gll^Fp, Gg^Fet, Gll^Fp, Gll^Fp
Wo, Wo, Wo, Wo, Wo, Wo, Wo, Wo, Wo, Wo, Wo, Wo, Ww, Ww, Wo, Wo, Wo, Wo, Wo, Wo, Ds, Ds, Ds, Ds, Gg, Gg, Gs, Gll^Fp, Gll^Fp, Gll^Fp, Gll^Fp, Hh^Fp, Gll^Fp, Mm, Mm, Gg^Ve, Hh^Fp, Gll^Fp, Gll^Fp, Gll^Fms, Gs, Gll^Fp, Gll^Fp, Gll^Fp, Gs, Gs, Gs, Gg, Gll^Fp, Gs^Fms, Gs^Fms, Gll^Fp, Gs^Fms, Gs^Fms, Gs, Gs^Fms, Gll^Fp, Gll^Fp
Wo, Wo, Wo, Wo, Wo, Wo, Wo, Ww, Ww, Ww, Wo, Wo, Ww, Wo, Wo, Wo, Wo, Wo, Wo, Wo, Ds, Ds, Ds, Gg, Gg, Gg, Gll^Fp, Gs, Gs, Gll^Fp, Hh^Fp, Hh^Fp, Hh^Fp, Mm, Mm, Gll^Fp, Hh^Fp, Gll^Fp, Gll^Fp, Gll^Fp, Gll^Fp, Gll^Fp, Gs, Hh^Fp, Gs, Gll^Fp, Gs, Gg, Gg^Fet, Gll^Fp, Gll^Fp, Gs^Fms, Hh^Fp, Gs, Gs, Gs, Gs^Fms, Gll^Fp
Wo, Wo, Wo, Wo, Wo, Wo, Wo, Wo, Wo, Wo, Ww, Wo, Wo, Wo, Wo, Wo, Ww, Wo, Wo, Ds, Ds, Ds, Gg, Gg, Gg, Gg, Gll^Fp, Gs^Fms, Gll^Fp, Hh^Fp, Hh^Fp, Mm, Mm, Mm, Mm, Gll^Fp, Hh^Fp, Gll^Fp, Gll^Fp, Gg, Gg, Gg, Gg, Gg, Hh^Fp, Gs, Gs, Hh^Fp, Hh^Fp, Gll^Fp, Hh^Fp, Hh^Fp, Gll^Fp, Gll^Fp, Hh^Fms, Gs, Gll^Fp, Gll^Fp
Wo, Wo, Wo, Wo, Wo, Wo, Ww, Wo, Ww, Wo, Ww, Wo, Ww, Wo, Wo, Wo, Ww, Wo, Wo, Ds, Ds, Gg, Gg, Gg, Gll^Fp, Gll^Fp, Gll^Fp, Gll^Fp, Gll^Fp, Gll^Fp, Gs, Hh^Fp, Hh^Fp, Gll^Fp, Gll^Fp, Gll^Fp, Gll^Fp, Hh^Fp, Gll^Fp, Gll^Fp, Gg, Gg, Gg, Gll^Fp, Gll^Fp, Gs, Hh^Fp, Gll^Fp, Hh^Fp, Gll^Fp, Mm, Mm, Gll^Fp, Hh^Fp, Gll^Fp, Gll^Fp, Gll^Fp, Gll^Fp
Wo, Wo, Wo, Wo, Wo, Wo, Ds, Wo, Wo, Ww, Ww, Wo, Wo, Wo, Ww, Ww, Wo, Ww, Ww, Ds, Ds, Gg, Gg, Gll^Fp, Gll^Fp, Gll^Fp, Gs, Gg, Gg^Fet, Gg, Gll^Fp, Gs, Gs, Gll^Fp, Hh^Fp, Hh^Fp, Gll^Fp, Gll^Fp, Gll^Fp, Gg, Gg, Gll^Fp, Gll^Fp, Gll^Fp, Gll^Fp, Gll^Fp, Hh^Fp, Gll^Fp, Gll^Fp, Gll^Fp, Mm, Mm, Gll^Fp, Hh^Fms, Gll^Fms, Gll^Fp, Gll^Fp, Gll^Fp
Wo, Wo, Wo, Wo, Gg, Gg, Gg, Ds, Ww, Ww, Ww, Wo, Ww, Wo, Wo, Ww, Wo, Ww, Wo, Ds, Ds, Gg, Gg, Gll^Fp, Gll^Fp, Gs, Gll^Fp, Gs, Gg, Gg, Gs^Fms, Gs^Fms, Gs, Gs, Gs^Fms, Gll^Fp, Gll^Fp, Gll^Fp, Gs, Gll^Fp, Gll^Fp, Gg^Ve, Gs, Hh^Fp, Hh^Fp, Gll^Fp, Gll^Fp, Hh^Fp, Hh^Fp, Mm, Mm, Mm, Gll^Fms, Gll^Fp, Hh^Fms, Gll^Fp, Gll^Fp, Gll^Fp
Wo, Wo, Wo, Wo, Gg, Gg^Vc, Ds, Ds, Wo, Ww, Wo, Wo, Ww, Wo, Ww, Wo, Ww, Wo, Wo, Ds, Gg, Gg, Gg, Gll^Fp, Gll^Fp, Hh^Fp, Hh^Fp, Gll^Fp, Gs, Gg^Ve, Gll^Fp, Gs^Fms, Gs^Fms, Gs^Fms, Gs^Fms, Gll^Fp, Gll^Fp, Gs, Hh^Fp, Gs, Gll^Fp, Gll^Fp, Gll^Fms, Gll^Fp, Hh^Fp, Gll^Fp, Gll^Fp, Hh^Fp, Hh, Gll^Fp, Hh, Hh^Fms, Gll^Fms, Gll^Fms, Gg^Ve, Gll^Fp, Gll^Fp, Gll^Fp
Wo, Wo, Wo, Ds, Ds, Ds, Ds, Ww, Wo, Ww, Wo, Ww, Wo, Wo, Wo, Ww, Ww, Ww, Wo, Gg, Gg, Gg, Gg, Gll^Fp, Gs, Gs, Gs^Fms, Gll^Fp, Gll^Fp, Hh^Fp, Gll^Fp, Gll^Fp, Gs, Gg, Gs, Gll^Fp, Gll^Fp, Gll^Fp, Hh^Fp, Gll^Fp, Hh^Fp, Gll^Fp, Gll^Fp, Hh^Fms, Gll^Fms, Gll^Fp, Gll^Fp, Gll^Fp, Gll^Fp, Mm, Hh, Hh^Fms, Gll^Fp, Hh^Fms, Gll^Fms, Gll^Fp, Gll^Fp, Gll^Fp
Wo, Wo, Wo, Wo, Wo, Wo, Wo, Wo, Wo, Wo, Wo, Wo, Ww^Vm, Wo, Wo, Ww, Ww, Ww, Ss, Ss, Gg, Gg, Gg, Gll^Fp, Gll^Fp, Gs, Gll^Fp, Gll^Fp, Gs, Hh^Fp, Gll^Fp, Gll^Fp, Gll^Fp, Gll^Fp, Gll^Fp, Gs, Gs, Hh^Fp, Gs, Hh^Fp, Hh^Fp, Gll^Fp, Gll^Fp, Gll^Fp, Gll^Fp, Hh^Fms, Gll^Fp, Gll^Fp, Gll^Fp, Gll^Fp, Gll^Fp, Hh^Fms, Gll^Fp, Gll^Fp, Gll^Fp, Gll^Fp, Gll^Fp, Gll^Fp
Wo, Wo, Wo, Wo, Wo, Wo, Ww, Wo, Wo, Wo, Wo, Wo, Wo, Wo, Wo, Wo, Ww, Ss, Ss, Ss, Gg, Gg, Gg, Gg, Gll^Fp, Gs, Gll^Fp, Hh^Fp, Hh^Fp, Gs, Gll^Fp, Gll^Fp, Gs, Gll^Fp, Gll^Fp, Gll^Fp, Hh^Fp, Gll^Fp, Gll^Fp, Gll^Fp, Gll^Fp, Gll^Fp, Gg, Gll^Fp, Gll^Fp, Hh^Fp, Gg, Gll^Fp, Gll^Fp, Gll^Fp, Gll^Fms, Gll^Fp, Hh^Fp, Gll^Fp, Gll^Fp, Gg^Fet, Gll^Fp, Gll^Fp
Wo, Wo, Wo, Wo, Wo, Wo, Ww, Ww, Wo, Wo, Wo, Wo, Wo, Wo, Ww, Ww, Wo, Ss, Ss, Gg, Gg, Gg, Gg^Fet, Gll^Fp, Gs^Fms, Gs^Fms, Gll^Fp, Gll^Fp, Gll^Fp, Gs, Gll^Fp, Gs, Gg, Gg, Gll^Fp, Gll^Fp, Gll^Fp, Gll^Fp, Gll^Fp, Gll^Fp, Gs, Gg, Gg, Gll^Fp, Gg, Gg, Gll^Fp, Gll^Fp, Gll^Fp, Gll^Fp, Hh^Fp, Gll^Fms, Gll^Fp, Hh^Fp, Gll^Fms, Gll^Fp, Gll^Fp, Gll^Fp
Wo, Wo, Wo, Wo, Wo, Ww, Wo, Ww, Ww, Wo, Wo, Wo, Ww, Wo, Wo, Ww, Ss, Ss, Ss, Gg^Ve, Gg, Gll^Fp, Gs^Fms, Gs^Fms, Gg, Gg, Gll^Fp, Gll^Fp, Gll^Fp, Gll^Fp, Gg, Gg, Gs, Gll^Fp, Gll^Fp, Gll^Fp, Gs, Gll^Fp, Gg, Gs, Gll^Fp, Gll^Fp, Hh^Fp, Gg, Gll^Fp, Gs, Gs, Gll^Fp, Gll^Fp, Hh^Fp, Gll^Fp, Gll^Fp, Gll^Fp, Hh^Fp, Hh^Fp, Gll^Fms, Hh^Fp, Gll^Fp
Wo, Wo, Wo, Wo, Wo, Wo, Wo, Wo, Wo, Wo, Ww, Ww, Ww, Ww, Wo, Ww, Ss, Ss, Ss, Gg, Gg, Gll^Fp, Gll^Fp, Gll^Fp, Gll^Fp, Gg, Gll^Fp, Gs, Gg, Gll^Fp, Gll^Fp, Gll^Fp, Hh^Fp, Gll^Fp, Gll^Fp, Gs, Gg, Gs, Gs, Gll^Fp, Gll^Fp, Gll^Fp, Gll^Fp, Gll^Fp, Gg^Ve, Gll^Fp, Gll^Fp, Hh^Fp, Gll^Fp, Gll^Fp, Gll^Fp, Gll^Fp, Mm, Hh, Hh^Fp, Gll^Fp, Mm, Gll^Fp
Wo, Wo, Wo, Wo, Ww, Wo, Wo, Wo, Wo, Wo, Ww, Ww, Wo, Ww, Ss, Ss, Ss, Ss, Ss, Gg, Cv, Gll^Fp, Cv, Gll^Fp, Gll^Fp, Gll^Fp, Gg^Fp, Gs, Gll^Fp, Gll^Fp, Hh^Fp, Hh^Fp, Hh^Fp, Hh^Fp, Hh^Fp, Gll^Fp, Gll^Fp, Gll^Fp, Gll^Fp, Gg, Gll^Fp, Gll^Fp, Gll^Fms, Gll^Fp, Hh^Fp, Gs, Hh^Fms, Hh^Fp, Hh^Fp, Mm, Mm, Mm, Mm, Mm, Gll^Fp, Mm, Mm^Xm, Mm^Xm
Wo, Wo, Wo, Wo, Wo, Ww^Vm, Ww, Ww, Wo, Wo, Ww, Wo, Wo, Ss, Ss, Ss, Ss, Ss, Cv, Cv, Cv, Cv, Cv, Cv, Cv, Gll^Fp, Gll^Fp, Gg^Ve, Gs, Gll^Fp, Hh^Fp, Hh^Fp, Hh^Fp, Hh^Fp, Hh^Fp, Hh^Fp, Hh^Fp, Gll^Fp, Gll^Fp, Gll^Fp, Gll^Fms, Gll^Fp, Hh^Fp, Hh^Fp, Hh^Fp, Hh^Fp, Hh^Fp, Hh^Fms, Gll^Fp, Hh^Fp, Mm, Mm, Mm, Mm, Mm^Xm, Mm^Xm, Mm^Xm, Mm^Xm
Wo, Wo, Wo, Wo, Ww, Wo, Ww, Wo, Ww, Wo, Ww, Ww, Ww, Ss, Ss, Ss, Ss, Ss, Cv, Cv, Cv, 2 Kv, Cv, Cv, Cv, Gll^Fp, Gll^Fp, Gs^Fms, Gll^Fp, Gs, Gll^Fp, Gll^Fp, Mm, Mm, Mm, Hh^Fp, Gll^Fp, Gs, Gll^Fp, Gll^Fp, Gll^Fms, Gg^Fet, Hh^Fp, Gll^Fp, Mm, Hh^Fp, Gll^Fp, Mm, Mm, Mm, Mm, Mm, Gll^Fp, Mm, Mm, Mm^Xm, Mm^Xm, Mm^Xm
Wo, Wo, Wo, Wo, Wo, Ww, Wo, Ww, Wo, Wo, Wo, Wo, Ww, Ww, Ww, Ss, Ss, Ss, Cv, Cv, Cv, Cv, Cv, Cv, Cv, Gll^Fp, Gll^Fp, Gs^Fms, Gll^Fp, Gll^Fp, Gll^Fp, Gll^Fp, Mm, Mm, Mm, Mm, Hh^Fp, Gll^Fp, Gg^Ve, Gll^Fp, Gll^Fp, Gll^Fms, Hh^Fp, Mm, Mm, Mm, Mm, Mm, Gll^Fp, Mm, Mm, Mm, Mm, Mm, Mm, Mm^Xm, Mm^Xm, Mm^Xm
Wo, Wo, Wo, Wo, Ww, Wo, Wo, Wo, Ww, Ds, Ds, Gg, Gg, Ww, Ww, Ww, Ww, Ss, Gg, Cv, Cv, Cv, Cv, Cv, Gg, Gll^Fp, Gll^Fp, Gs^Fms, Gs^Fms, Gg^Fet, Hh^Fp, Hh^Fp, Hh^Fp, Gll^Fp, Hh^Fp, Gll^Fp, Gs, Gs, Gg, Gll^Fp, Hh^Fms, Hh^Fms, Hh^Fp, Hh, Mm, Mm, Mm, Mm, Hh^Fms, Hh^Fms, Mm, Gll^Fp, Mm, Mm^Xm, Mm^Xm, Mm^Xm, Mm^Xm, Mm^Xm
Wo, Wo, Ww, Wo, Wo, Wo, Ww, Ds, Ds, Ds, Ds, Gg, Gg, Ss, Ss, Ww, Ww, Ww, Ww, Ww, Ww, Ww, Gg, Gg, Gg^Fp, Gll^Fp, Gs^Fms, Gs^Fms, Gll^Fp, Gll^Fp, Gll^Fp, Hh^Fp, Gll^Fp, Gll^Fp, Gll^Fp, Gg, Gll^Fp, Gs, Gll^Fp, Hh^Fms, Hh, Hh^Fp, Mm, Mm, Mm, Mm, Mm, Hh^Fp, Hh^Fp, Hh^Fms, Gll^Fp, Mm, Mm, Mm^Xm, Mm^Xm, Mm^Xm, Mm^Xm, Mm^Xm
Ww, Ww, Ww, Ww, Ww, Ww, Ds, Ds, Ds, Ds, Gg, Gg, Gll^Fp, Gll^Fp, Gll^Fp, Ss, Ss, Ss, Gll^Fp, Ss, Ss, Ss, Gll^Fp, Gg, Gll^Fp, Gs^Fms, Gs^Fms, Gs^Fms, Gs, Gll^Fp, Gs, Gll^Fp, Gg, Gll^Fp, Gll^Fp, Gg, Gg, Gll^Fp, Hh^Fp, Hh^Fms, Hh^Fp, Hh, Mm, Gll^Fp, Mm^Xm, Mm^Xm, Mm, Mm, Mm, Hh^Fp, Mm^Xm, Mm^Xm, Mm, Mm, Mm, Mm^Xm, Mm^Xm, Mm^Xm
Wo, Wo, Wo, Wo, Ww, Ww, Ds, Ds, Gg, Ds, Gg, Gll^Fp, Gll^Fp, Gg^Ve, Gg, Gll^Fp, Gll^Fp, Gg^Fet, Gs^Fms, Gll^Fp, Gs^Fms, Gll^Fp, Gs^Fms, Gll^Fp, Gs^Fms, Gll^Fp, Gs^Fms, Gs, Gll^Fp, Gs, Gll^Fp, Gg^Ve, Gll^Fp, Gg, Gll^Fp, Gll^Fp, Gll^Fp, Gll^Fp, Hh^Fp, Hh^Fp, Hh, Gll^Fp, Mm, Mm^Xm, Mm^Xm, Mm^Xm, Mm^Xm, Mm^Xm, Mm^Xm, Mm^Xm, Mm, Mm^Xm, Mm, Mm, Mm, Mm^Xm, Mm^Xm, Mm^Xm
Wo, Ww, Wo, Ds, Ds, Ds, Ds, Ds, Gg, Gg, Gg, Gll^Fp, Gll^Fp, Gll^Fp, Gll^Fp, Hh^Fp, Hh^Fp, Hh^Fp, Hh^Fp, Gs^Fms, Gll^Fp, Gll^Fp, Gll^Fp, Gs^Fms, Gll^Fp, Gs^Fms, Gll^Fp, Gll^Fp, Gll^Fp, Gll^Fp, Gll^Fp, Gs, Gll^Fp, Gll^Fp, Gll^Fp, Gll^Fp, Gll^Fp, Gll^Fp, Gll^Fp, Gll^Fp, Gll^Fp, Mm, Mm, Mm^Xm, Mm^Xm, Mm^Xm, Mm^Xm, Mm^Xm, Mm^Xm, Mm^Xm, Mm^Xm, Mm^Xm, Mm^Xm, Mm, Mm^Xm, Mm^Xm, Mm^Xm, Mm^Xm
