border_size=1
usage=map

Hh, Hh, Ha, Gs, Mm, Mm, Mm, Mm^Xm, Mm^Xm, Mm^Xm, Mm^Xm, Mm^Xm, Mm^Xm, Mm^Xm, Mm, Gs, Ha^Fda, Gs, Hh, Gs, Gs, Gs, Gs^Fdw, Gs^Fdw, Gs^Fmw, Gs, Gs^Fmw, Gs^Fmw, Gs, Gs, Gs, Gs, Gs, Gs, Hh, Hh, Hh, Gs, Hh, Hh, Gs, Gs, Gs, Gs, Hh, Hh, Mm, Mm, Mm^Xm, Mm^Xm, Mm^Xm, Mm^Xm
Hh, Hh, Hh, Mm, Ms, Ms, Mm^Xm, Ms^Xm, Ms^Xm, Ms^Xm, Mm^Xm, Mm^Xm, Mm^Xm, Mm^Xm, Ms, Mm, Hh, Ha, Ha^Fda, Hh, Gs, Gs^Fdw, Gs^Fmw, Gs^Fmw, Gs^Ve, Gs^Fp, Gs^Fp, Gs^Fp, Gs^Fp, Gs, Aa^Fda, Gs, Gs^Fp, Ha^Fda, Ha^Fda, Ha^Fda, Ha, Hh, Hh, Ha, Gs, Gs^Fp, Gs, Ha^Fda, Mm, Mm, Ms, Mm, Mm, Mm^Xm, Mm^Xm, Mm^Xm
Gs, Hh^Fdw, Hh, Ha, Mm, Ms, Mm^Xm, Ms^Xm, Mm^Xm, Mm^Xm, Wog, Mm^Xm, Mm, Ms, Mm, Mm, Ha^Fda, Ha^Fda, Hh, Hh, Gs, Gs^Fmw, Gs, Gs, Aa, Aa, Gs^Fmw, Gs^Fmw, Aa, Aa, Aa^Fda, Gs^Fp, Gs^Fp, Gs^Fda, Gs, Ha^Fda, Hh, Hh, Gs^Fp, Gs, Aa, Gs^Fp, Gs^Fp, Ha^Fda, Hh, Mm, Ms, Mm, Mm^Xm, Ms^Xm, Ms^Xm, Ms^Xm
Gs, Gs^Fp, Gs, Ha, Ha^Fpa, Mm, Mm, Mm^Xm, Mm, Mm, Mm, Wog, Mm, Mm, Mm, Ha, Hh, Hh, Hh^Fmw, Gs^Fmw, Aa, Aa, Gs, Gs^Fdw, Co, Aa, Co, Gs, Co, Gs, Aa^Fda, Gs, Gs, Gs^Fp, Gs^Fp, Gs, Gs^Fp, Gs, Aa, Gs^Fp, Aa^Fpa, Gs^Fp, Gs, Hh, Ha, Hh, Mm, Ms, Ms, Ms^Xm, Ms^Xm, Mm^Xm
Gs, Aa, Gs^Fp, Hh, Ha, Ha^Fpa, Ha^Fpa, Mm, Hh, Ha, Hh, Wog, Wog, Ha, Ha^Fpa, Ha^Fpa, Hh^Fmw, Hh^Fmw, Gs, Gs, Gs, Gs, Gs, Co, Co, Co, 1 Ko, Co, Co, Co, Aa, Aa, Aa, Gs^Fmw, Gs^Fp, Gs^Fp, Gs, Aa^Fp, Aa^Fpa, Aa^Fpa, Aa, Aa, Gs, Gs^Ve, Ha, Ha^Fda, Mm, Wog, Mm, Ms, Ms, Mm^Xm
Gs^Fp, Gs^Fp, Gs^Fp, Gs^Fdw, Gs^Fdw, Gs, Ha, Hh, Gs, Ha^Fpa, Gs^Ve, Wog, Wwg, Ha^Fpa, Hh, Hh, Gs^Fp, Gs^Fmw, Gs^Fmw, Gs^Ve, Gs, Aa, Gs, Co, Co, Co, Co, Co, Co, Co, Gs^Fp, Gs, Gs, Gs, Gs^Ve, Gs^Fp, Gs^Fp, Aa, Aa, Aa, Gs^Fp, Gs, Gs^Fp, Gs^Fp, Gs^Fmw, Ha^Fpa, Ha^Fpa, Wog, Mm, Mm, Ms, Mm
Ha, Hh, Hh, Hh^Fdw, Gs, Gs^Fdw, Gs, Gs, Aa, Gs, Gs, Gs, Wwg, Gs, Gs, Hh, Gs^Fp, Gs, Gs^Fdw, Gs, Gs, Aa, Aa, Gs, Gs^Fp, Gs, Aa, Aa^Fp, Gs, Gs, Gs, Gs, Ha^Fda, Gs, Ha^Fda, Gs, Gs, Gs, Gs^Fp, Gs, Gs^Fp, Gs^Fp, Gs, Gs, Sm, Gs^Fmw, Gs^Fmw, Wog, Ha^Fda, Ms, Mm, Mm
Ha, Ha, Ha, Ha, Mm, Gs, Gs, Gs, Gs, Gs, Gs, Gs^Fmw, Gs, Wwg, Wwg, Gs, Gs, Gs^Fp, Gs, Gs, Gs, Gs, Gs, Gs, Gs^Fp, Gs^Fmw, Gs^Fmw, Gs^Fp, Gs^Fp, Gs^Fmw, Gs^Fmw, Gs, Ha^Fda, Gs, Ha, Ha^Fda, Ha, Gs, Ha, Gs, Gs^Fp, Gs^Fp, Ss, Ss, Wwg, Wwg, Wwg, Wwg, Gs, Mm, Hh^Fp, Mm
Mm, Mm, Mm, Ms, Mm, Mm, Hh, Gs^Fp, Gs^Fp, Aa, Aa, Gs^Fmw, Gs, Ss, Ss, Wwg, Wwg, Gs, Ss, Gs, Gs, Gs, Gs, Gs, Gs, Gs, Gs^Fmw, Gs, Gs, Gs^Fp, Gs^Fmw, Gs, Gs^Fmw, Gs, Hh, Mm, Mm, Hh, Ha^Fpa, Ha, Gs^Fp, Sm, Wwg, Wwg, Wwg, Ss, Ss, Sm, Gs^Fmw, Gs^Fp, Gs^Fp, Gs
Mm, Ms, Ms, Ms, Ms, Mm, Ha^Fpa, Gs, Gs^Fmw, Gs, Aa^Fmw, Gs^Fmw, Gs, Gs, Hh, Ss, Gs, Wwg, Wwg, Ss, Wwg, Ss, Gs, Gs, Gs, Aa^Fda, Aa^Fda, Gs, Gs, Gs^Fmw, Aa, Gs, Gs^Fmw, Gs^Fmw, Gs, Hh, Mm, Mm, Ha, Ha^Fpa, Gs, Sm, Sm, Ss, Ss, Wwg, Gs, Gs^Fmw, Gs^Fmw, Aa, Gs^Fp, Gs
Ms^Xm, Ms^Xm, Mm^Xm, Ms, Mm, Ha, Ha, Gs, Gs^Fp, Gs^Fmw, Aa, Gs, Gs, Gs, Mm, Mm, Hh, Sm, Sm, Wwg, Wwg, Wwg, Wwf, Gs, Gs, Aa, Gs, Aa, Gs^Ve, Gs, Gs, Gs, Gs, Gs, Hh, Hh, Hh, Mm, Hh, Ha^Fpa, Gs, Gs^Fp, Gs, Gs, Gs^Fmw, Ss, Gs, Gs^Fp, Hh^Fda, Gs^Fmw, Mm, Hh
Ms^Xm, Ms^Xm, Ms^Xm, Mm, Ha, Ha^Fda, Ha^Fda, Gs, Gs, Gs, Gs^Fmw, Gs, Gs, Ha^Fda, Ha^Fda, Mm, Ha, Gs^Ve, Gs, Wwg, Ss, Wwg, Wwf, Gs^Fmw, Gs^Fp, Gs^Fp, Aa^Fp, Gs, Aa, Gs, Gs, Hh, Gs^Fp, Gs, Gs^Fp, Gs, Gs, Gs, Gs, Gs, Gs^Fp, Gs^Fp, Gs^Fp, Gs^Fmw, Gs^Fp, Gs^Fmw, Gs, Ha^Fda, Ha, Hh, Ms, Mm
Mm^Xm, Mm^Xm, Ms, Ha, Ha, Ha^Fda, Ha, Gs, Gs, Gs^Ve, Gs^Fdw, Gs, Gs^Fp, Gs, Gs, Hh, Gs, Gs, Gs, Ss, Sm, Wwg, Wwf, Gs^Fmw, Gs^Fp, Gs, Gs, Gs, Gs, Gs, Gs, Gs^Fp, Gs, Gs^Fp, Gs, Gs^Ve, Aa, Gs, Aa, Gs, Gs, Gs^Fp, Aa, Aa^Fp, Gs^Fp, Gs^Fp, Gs, Ha^Fda, Ms, Ms, Mm^Xm, Mm^Xm
Ms, Ms, Mm, Mm, Ha^Fpa, Ha^Fpa, Gs, Gs, Gs, Gs^Fmw, Gs^Fdw, Gs, Gs, Gs, Gs, Gs, Gs, Gs^Fp, Gs^Fp, Gs, Sm, Wwf, Wwf, Wwf, Wwf, Gs, Aa, Gs, Gs, Gs^Fp, Aa, Aa, Gs, Wwf, Wwg, Gs, Gs, Aa^Fpa, Aa^Fpa, Gs, Gs^Fmw, Gs^Fp, Aa, Gs^Ve, Gs^Fp, Gs^Fmw, Gs, Mm, Ms, Mm, Ms^Xm, Ms^Xm
Mm, Mm, Mm, Ha, Ha^Fpa, Ha, Gs, Gs^Fmw, Gs^Fp, Gs^Fmw, Gs^Fp, Gs, Ss, Ss, Wwf, Gs, Gs^Fp, Gs, Rb, Gs, Rb, Rb, Aa, Wwf, Gs, Aa, Aa, Gs, Gs, Gs, Gs, Gs, Aa^Fda, Wwf, Wwg, Wwg, Gs, Gs, Gs^Fmw, Gs, Gs^Fp, Gs^Fp, Gs, Gs^Fp, Aa^Fp, Gs^Fmw, Gs, Hh, Mm, Ms, Ms^Xm, Ms^Xm
Mm, Mm, Ha^Fda, Ha, Ha, Gs, Gs, Gs, Gs^Fp, Gs^Fp, Gs, Gg^Fet, Gs^Fp, Wwg, Wwf, Gs^Fp, Rb, Rb, Rb^Fdw, Rb, Aa, Aa, Rb, Rb, Rb^Edt, Rb, Rb^Edt, Rb, Qxu, Gs, Aa, Aa^Fda, Gs, Gs, Rb, Ss, Gs, Gg^Fet, Gs, Gs, Gs^Fp, Gs^Fp, Gs^Fp, Gs^Fp, Gs^Fmw, Aa^Fda, Gs, Ha^Fpa, Mm, Ms, Ms, Mm^Xm
Ha, Ha, Ha^Fda, Hh, Gs, Gs^Fp, Gs^Fp, Gs^Fp, Gs, Gs, Ss, Gs, Gs^Fp, Gs, Rb, Rb^Edt, Aa, Rb^Edb, Aa, Rb, Rb, Aa, Rb, Rb^Edb, Rb^Dr, Rb^Edt, Rb, Rb, Qxu, Rb, Rb, Rb, Rb, Rb, Rb^Fdw, Rb, Gs, Gs, Gs^Fp, Gs, Gs, Aa^Fdw, Gs^Fdw, Gs^Fmw, Gs^Fmw, Gs, Gs^Fdw, Ha^Fpa, Ha^Fpa, Ms, Ms, Mm
Gs, Ha, Gs, Ha^Fpa, Gs, Gs^Fp, Gs^Fmw, Gs^Fmw, Gs, Ss, Wwg, Ss, Gs, Rb, Rb^Edt, Aa, Aa, Rb, Rb, Rb, Rb, Aa, Rb, Rb^Edb, Rb^Fdw, Rb^Fdw, Rb^Fdw, Rb^Fdw, Rb, Rb^Dr, Rb, Rb, Rb^Fdw, Rb^Fdw, Sm, Rb, Ss, Gs, Gs, Gs^Fp, Gs^Fp, Aa^Fdw, Gs^Fp, Gg^Fet, Aa^Fp, Gs^Fdw, Aa^Fpa, Gs^Fdw, Gs^Fdw, Hh, Hh, Ms
Gs, Gs, Gs, Gs^Fmw, Gs^Fmw, Gs^Fmw, Gg^Fet, Gs^Ve, Ss, Ss, Wwg, Wwg, Wwf, Rb^Edt, Qxu, Rb, Rb, Aa, Rb, Rb^Fdw, Rb^Fdw, Rb, Rb^Edt, Rb^Vhcr, Rb, Rb^Fdw, Rb, Rb^Fdw, Rb^Edt, Rb^Edb, Rb, Rb^Fetd, Rb^Fdw, Rb, Sm, Ss, Ss, Rb, Rb, Gs, Aa, Gs, Gs^Fp, Gs^Fp, Gs^Fdw, Aa^Fpa, Aa^Fmw, Aa^Fdw, Gs, Gs^Fdw, Gs^Fp, Hh
Aa^Fda, Aa^Fda, Gs^Fmw, Gs^Fmw, Aa^Fmw, Gs^Fmw, Gs, Ss, Ss, Wwg, Wwg, Wwf, Rb^Edt, Rb^Edt, Rb, Qxu, Rb^Fdw, Sm, Sm, Rb^Fdw, Qxu, Qxu, Rb, Rb^Edt, Rb, Rb, Aa, Rb, Rb, Rb^Edt, Rb^Fdw, Rb^Fdw, Rb^Fdw, Rb, Wwf, Wwg, Rb^Fdw, Rb, Rb^Vhcr, Rb, Rb, Gs^Fp, Gs^Fp, Gs^Fp, Gs^Fdw, Gs, Gs^Fmw, Aa^Fp, Gs^Fp, Gs^Fp, Gs^Fp, Gs^Fp
Gs, Aa, Gs^Fmw, Gs^Fmw, Gs^Fmw, Aa, Aa^Fda, Gs, Gs^Fmw, Gs, Gs^Fp, Rb, Rb^Edt, Aa^Fda, Aa, Rb, Rb, Sm, Rb^Fetd, Rb, Rb^Fdw, Rb, Rb, Rb^Dr, Qxu, Rb, Rb, Aa, Rb, Rb, Rb^Edb, Rb^Fdw, Rb, Qxu, Qxu, Rb^Fdw, Rb^Fdw, Rb, Rb, Rb, Rb, Gs, Wwg, Ss, Ss, Gs^Fmw, Gs, Gs^Fp, Gs^Fmw, Aa^Fp, Aa^Fpa, Gs
Gs, Gs, Gs^Fmw, Gs, Gs^Fmw, Aa, Gs^Fmw, Gs, Gs^Fmw, Gs^Fp, Gs^Fmw, Rb, Rb, Rb^Edt, Rb^Edt, Rb, Rb^Fdw, Rb^Fdw, Rb, Rb, Rb, Rb^Fdw, Rb^Fdw, Rb, Rb, Qxu, Qxu, Rb, Rb^Fdw, Rb^Fdw, Rb, Rb, Aa, Rb^Dr, Rb, Rb, Rb^Fdw, Rb^Fdw, Rb, Rb^Dr, Wwf, Wwf, Wwg, Wwg, Ss, Gs^Fmw, Gg^Fet, Gs^Fdw, Gs^Fdw, Gs, Gs^Fdw, Gs
Ha^Fpa, Ha, Hh, Gs^Fmw, Gs, Gs^Fmw, Aa^Fda, Aa, Gs^Fmw, Aa^Fda, Gs^Fmw, Gs^Fp, Rb, Rb, Rb, Rb, Rb^Fdw, Qxu, Qxu, Qxu, Rb^Edb, Rb, Rb, Rb, Rb^Fdw, Rb^Fdw, Rb, Rb^Fdw, Rb^Fdw, Rb^Edt, Qxu, Aa, Rb, Rb, Aa, Aa, Rb, Rb, Rb^Fdw, Rb, Rb, Wwf, Gs, Wwg, Gs^Fp, Gs, Gs^Fp, Gs^Fmw, Gs^Fdw, Gs^Fdw, Hh^Fdw, Gs
Ha^Fpa, Ha^Fda, Ha^Fpa, Ha, Gs, Gs^Fmw, Gg^Fet, Gs, Gs^Fmw, Aa^Fda, Gs^Fmw, Gs^Fp, Rb, Aa^Fda, Aa^Fda, Aa, Rb, Rb, Rb^Fdw, Qxu, Rb, Rb^Dr, Rb, Wwf, Rb^Fdw, Rb^Fdw, Rb^Fdw, Rb^Fetd, Rb^Fdw, Qxu, Qxu, Aa, Rb, Rb^Fdw, Rb, Rb^Edt, Rb, Rb^Fdw, Rb^Fdw, Rb^Edb, Rb, Wwf, Gs^Fmw, Gs^Fdw, Gs^Fp, Gs^Fdw, Gs^Fmw, Gs^Fmw, Ha, Ha^Fdw, Hh, Gs
Ha^Fpa, Wwg, Wwg, Ha^Fda, Gs^Fmw, Gs^Fp, Gs, Gs, Ss, Gs, Gs, Gs^Fp, Rb, Rb, Rb, Aa, Rb^Vhcr, Rb, Rb, Rb^Fdw, Aa, Rb, Rb, Wwf, Rb, Sm, Sm, Rb^Fdw, Rb, Qxu, Rb^Fdw, Rb^Fdw, Sm, Rb^Fdw, Rb^Fdw, Rb, Qxu, Rb, Rb, Rb^Fetd, Rb^Vhcr, Rb, Gs^Fmw, Gs^Fmw, Aa^Fmw, Gs^Fmw, Gs^Fdw, Gs, Ha^Fpa, Md, Md, Gs
Ha^Fpa, Ha, Hh, Hh, Gs^Fmw, Gs^Fp, Gs^Fp, Wwg, Ss, Gs^Fmw, Gs, Rb^Fp, Rb^Fmw, Rb, Rb, Aa, Rb, Rb, Rb^Fdw, Rb^Fdw, Rb, Aa, Rb, Rb^Dr, Rb, Sm, Sm, Rb, Rb^Edt, Rb^Vhcr, Wwf, Rb^Fdw, Sm, Sm, Rb^Fdw, Qxu, Rb, Rb^Dr, Aa, Rb, Wwf, Rb, Rb^Fmw, Gs^Fmw, Aa^Fmw, Aa^Fdw, Gs^Fmw, Gs, Ha, Md, Md, Gs
Ha, Ha^Fda, Hh, Gs, Gs, Gs^Fmw, Gs, Gs^Ve, Gs, Gs^Fmw, Gs^Fmw, Rb, Rb, Rb^Fmw, Rb^Edt, Rb, Sm, Rb, Rb, Rb^Fdw, Qxu, Rb, Rb^Edt, Rb^Vhcr, Rb, Rb, Rb, Rb, Rb, Rb, Wwf, Wwf, Sm, Sm, Rb^Fdw, Qxu, Rb, Aa, Wwf, Wwf, Wwf, Rb, Rb, Gs^Fmw, Gs^Fmw, Aa^Fp, Gs^Fp, Hh, Hh^Fmw, Ha^Fpa, Ha^Fpa, Gs
Gs, Gs, Gs, Gs, Gs^Fmw, Gs, Aa^Fpa, Gs^Fp, Gs, Gs, Gs^Fmw, Gs^Fp, Rb^Fmw, Rb^Fmw, Rb^Edt, Sm, Sm, Sm, Rb^Fdw, Qxu, Qxu, Qxu, Rb, Rb^Edb, Rb, Chr, Chr, Chr, Rb, Rb, Rb^Edt, Wwf, Rb, Rb, Rb, Rb^Fdw, Rb, Sm, Sm, Sm, Rb^Fdw, Rb^Edb, Rb, Gs^Fdw, Gs^Fdw, Gs^Fp, Gg^Fet, Gs, Gs^Fmw, Hh, Hh, Gs
Gs^Fp, Gs^Fp, Gs^Fmw, Gs^Fmw, Gs^Fmw, Aa^Fmw, Aa^Fpa, Gs^Fp, Gs^Fp, Aa, Aa^Fpa, Rb^Fmw, Rb^Edt, Rb^Edt, Rb^Edt, Rb, Rb^Edt, Sm, Rb^Fdw, Rb, Rb^Edt, Rb, Chr, Rb, Aa, Rb, Chr, Rb^Edt, Qxu, Rb, Chr, Rb, Rb^Edt, Rb^Vhcr, Aa, Rb, Rb, Rb^Fdw, Rb^Fdw, Rb, Rb^Dr, Rb, Rb, Gs^Fdw, Gs^Fmw, Gs^Fmw, Gs^Fmw, Gs^Fp, Gs^Fp, Hh^Fp, Gs^Fp, Hh
Gs^Fp, Gs^Fp, Gs^Fp, Gs^Fmw, Gs^Fmw, Aa^Fp, Gg^Fet, Gs^Fmw, Gs^Fmw, Gs^Fmw, Gs, Rb, Rb^Edt, Ss, Wwg, Rb, Rb, Rb, Rb^Fdw, Rb, Rb, Rb, Chr, Rb, Rb, Aa, Chr, Qxu, Qxu, Rb, Chr, Rb, Rb, Aa, Aa, Rb, Rb, Rb, Rb, Rb, Rb, Rb, Rb^Fmw, Gs^Fmw, Aa, Gs, Aa^Fpa, Gs, Gs^Fp, Gs^Fmw, Gs^Fp, Gs
Gs^Fp, Gs, Gs, Gs^Fmw, Gs^Fmw, Gs^Fp, Gs^Fp, Gs^Fp, Gs^Fp, Gs^Fp, Gs^Fmw, Rb, Rb, Ss, Wwg, Wwg, Rb^Vhcr, Rb, Qxu, Rb, Rb, Chr, Rb, Chr, Chr, Rb, Chr, Qxu, Chr, Chr, Rb, Chr, Rb, Rb, Rb, Qxu, Rb, Wwg, Wwg, Ss, Rb, Rb, Rb^Fp, Gs^Fmw, Aa^Fpa, Aa^Fpa, Gs, Gs^Fp, Gs^Fp, Gs^Fmw, Gs^Fp, Gs
Gs^Fp, Ms, Ha, Ha^Fmw, Gs^Fmw, Gs^Fmw, Gs, Gs^Fp, Aa^Fpa, Gs, Gs^Fp, Gs, Ss, Wwg, Ss, Wwg, Rb, Rb^Edb, Rb, Qxu, Qxu, Qxu, Qxu, Rb, Rb, Chr, 2 Khr, Chr, Rb, Rb^Edt, Rb^Edt, Rb, Rb, Rb^Dr, Qxu, Qxu, Rb^Fdw, Ss, Rb^Edb, Rb, Qxu, Rb, Rb^Fmw, Gs^Fp, Gs^Fp, Gs^Fp, Wwg, Ss, Gs, Gs^Fmw, Gs^Fp, Gs
Gs, Ha^Fpa, Hh, Hh, Mm, Gs, Gs, Gs^Fmw, Gs, Aa^Fp, Gs^Fp, Gs, Rb, Ss, Rb, Rb, Rb, Rb^Dr, Sm, Rb, Rb, Rb^Edt, Rb, Rb^Edt, Chr, Chr, Chr, Chr, Chr, Rb^Edt, Rb, Rb, Rb^Edt, Qxu, Rb^Vhcr, Rb^Fdw, Rb, Rb, Rb^Edb, Rb^Edt, Rb^Fdw, Rb, Rb, Gs^Fp, Gs, Ss, Wwg, Wwg, Gs^Fp, Gs^Fp, Gs^Fmw, Gs
Aa, Aa, Mm, Hh, Mm, Gs, Gs^Fp, Gs^Fmw, Gs^Fmw, Gs, Aa^Fpa, Gs^Fp, Rb, Rb^Fdw, Rb^Fdw, Rb^Edt, Aa, Wwf, Wwf, Rb, Rb, Chr, Chr, Chr, Rb, Rb, Chr, Rb, Rb, Chr, Chr, Chr, Rb, Rb, Aa, Rb, Aa, Rb^Edb, Rb, Rb^Fdw, Rb^Fdw, Rb^Fetd, Rb, Gs^Fdw, Gs^Fdw, Gs, Gg^Fet, Gs^Fp, Aa^Fp, Gs^Fmw, Gs^Fp, Gs
Gs^Fp, Ha, Mm, Hh, Mm, Gs, Gs^Fp, Gs^Fmw, Gs^Fmw, Aa^Fpa, Aa^Fpa, Aa, Rb, Rb, Rb^Fetd, Rb^Fdw, Rb, Aa, Aa, Aa, Rb, Rb, Chr, Rb, Qxu, Rb, Chr, Rb, Aa, Rb, Chr, Rb, Rb, Rb, Rb, Aa, Aa, Rb, Rb^Fdw, Rb^Fdw, Rb^Edt, Rb, Gs, Gs^Fdw, Gs, Gs^Fmw, Gs^Fmw, Aa^Fp, Aa^Fmw, Gs^Fmw, Gs^Fp, Gs^Fp
Aa, Aa, Mm, Mm, Mm, Gs, Gg^Fet, Gs^Fmw, Gs, Gs, Gs^Fp, Gs^Fp, Gs^Fp, Rb, Rb, Rb^Fdw, Rb^Fdw, Rb, Rb, Aa, Rb, Rb, Rb^Fdw, Rb, Rb, Rb, Chr, Rb, Wwf, Rb, Rb^Edb, Rb, Qxu, Rb, Rb^Fdw, Rb, Rb, Rb, Rb, Rb, Rb^Edt, Rb, Aa^Fpa, Aa, Aa, Gs, Gs^Fp, Gs^Fp, Gs^Fmw, Gs^Fp, Hh, Gs^Fp
Gs^Fp, Aa, Ha, Gs, Gs, Gs, Gs, Gs, Ss, Ss, Ss, Gs^Fp, Gs^Fp, Gs^Fmw, Gs, Qxu, Qxu, Rb^Fdw, Rb^Fdw, Rb^Vhcr, Rb^Edt, Rb^Edt, Rb^Fdw, Rb^Fdw, Rb, Chr, Rb, Chr, Rb, Rb, Rb, Qxu, Rb^Fdw, Rb^Fdw, Rb^Fdw, Rb^Fdw, Rb, Rb, Rb^Edt, Rb^Edt, Aa, Aa^Fpa, Gs^Fp, Gs, Gs^Fp, Gs^Fmw, Gs^Fp, Gs^Fmw, Hh^Fmw, Gs, Hh, Hh
Gs, Gs^Fp, Gs^Fp, Gs^Fp, Aa^Fpa, Aa^Fpa, Gs, Gs, Wwg, Ss, Wwg, Gs^Ve, Gs, Gs^Fp, Aa^Fda, Rb, Rb^Edt, Rb^Fdw, Rb^Fdw, Rb^Fdw, Sm, Rb, Rb, Rb^Fetd, Rb^Edt, Rb, Rb, Rb, Aa, Aa, Wwf, Sm, Sm, Rb^Fdw, Sm, Rb, Rb, Rb^Dr, Rb, Rb, Gs^Fp, Gs^Fp, Gs, Gs^Fp, Ha^Fpa, Gs, Hh, Gs, Gs, Ha^Fda, Mm, Ha
Gs, Hh, Gs^Fp, Gs^Fp, Aa^Fpa, Aa^Fpa, Gs, Wwg, Ss, Ss, Wwg, Wwg, Ss, Gs, Aa^Fda, Aa^Fda, Aa^Fda, Rb, Rb, Sm, Wwf, Aa^Fda, Aa^Fda, Aa^Fda, Rb^Edt, Rb^Edt, Rb^Dr, Rb, Rb^Edt, Wwf, Rb, Sm, Sm, Sm, Rb, Rb^Fetd, Rb^Edt, Rb, Rb, Gs^Fdw, Gs^Fdw, Gs^Fdw, Gs, Ha, Ha^Fpa, Ha, Hh, Hh, Hh, Ha^Fda, Ms, Ha
Ha, Ha^Fpa, Hh, Gs, Gs, Aa^Fpa, Gs^Fp, Wwg, Wwg, Wwg, Wwg, Wwg, Gs^Fmw, Wwg, Wwg, Gs, Gs^Fp, Gs^Fp, Gs, Rb, Rb, Wwf, Gs, Rb, Rb, Rb, Rb, Rb^Edt, Rb, Rb, Rb, Sm, Gs, Rb, Rb, Rb, Rb^Edt, Rb^Edt, Wwg, Wwg, Wwg, Gs^Fmw, Gs, Gg^Fet, Hh, Md, Wwg, Ha^Fda, Ha, Ms, Mm, Mm^Xm
Ha, Ha^Fpa, Hh, Hh, Hh, Gs, Gs^Fp, Wwg, Wwg, Wwg, Wwg, Gg^Fet, Ss, Wwg, Wwg, Ss, Aa, Gs^Fp, Md, Md, Gs, Aa, Aa^Fpa, Aa^Fpa, Gs, Gs, Ss, Gs, Gs, Aa, Aa, Gs, Gs, Gs, Hh, Gs, Wwg, Wwg, Ss, Ss, Ss, Wwg, Wwg, Ha, Wwg, Wwg, Ms, Wwg, Wwg, Ms, Ms^Xm, Mm^Xm
Ms, Ms, Ms, Ha, Gs, Hh, Hh, Ss, Wwg, Ss, Gs, Wwg, Ss, Wwg, Wwg, Ss, Gs, Gs, Ha^Fda, Md, Md, Ha^Fpa, Wwg, Ss^Fpa, Ss, Wwg, Wwg, Gs, Gs^Fmw, Gs, Gs, Aa, Gs, Gs, Ha, Wwg, Ha, Wwg, Ss, Ss, Wwg, Wwg, Gs, Wwg, Md, Ha, Mm, Mm, Wwg, Mm^Xm, Ms^Xm, Mm^Xm
Ms, Ms, Mm, Mm, Ha, Hh, Wog, Wwg, Ha^Fda, Ha^Fpa, Gs, Gs^Fp, Gs^Fp, Wwg, Gs^Fmw, Gs, Hh^Fpa, Ha^Fda, Md, Ha, Hh^Fet, Ha^Fpa, Ha^Fda, Ss, Wwg, Wwg, Ss, Gs, Gg^Fet, Gs^Fmw, Gs^Ve, Aa^Fmw, Aa, Gs, Ha^Fda, Ha^Fda, Md, Wwg, Wwg, Ss, Wwg, Wwg, Gs, Gs, Hh, Ha^Fda, Mm, Mm, Wog, Wog, Wog, Ms^Xm
Ms^Xm, Mm, Ms, Mm, Wog, Wog, Wog, Wwg, Ha, Gs, Ha^Fpa, Aa, Aa, Gs, Ha, Hh, Hh^Fpa, Hh, Mm, Mm, Md, Hh^Fda, Ha^Fda, Wwg, Wwg, Wwg, Wwg, Gs, Gs^Fp, Gs^Fp, Aa^Fp, Gs^Fmw, Gs^Fmw, Gs, Gs, Gg^Fet, Gs, Ss, Gs, Wwg, Gs, Gs, Gs^Fdw, Gs^Fmw, Hh^Fmw, Hh, Ha^Fpa, Ms, Mm, Wog, Mm^Xm, Mm^Xm
Ms^Xm, Ms^Xm, Ms, Ms, Ms, Mm, Mm, Mm, Ms, Ha, Ha^Fpa, Gs^Fp, Gs^Fp, Hh, Hh^Fpa, Ha, Mm, Ms, Ms, Ms, Ms, Ha^Fda, Wwg, Wwg, Wwg, Ha, Ha^Fda, Gs, Gs^Fp, Gs^Fp, Gs^Fp, Gs^Fp, Aa^Fdw, Aa^Fp, Gs^Fdw, Gs, Gs, Gs, Gs, Gs^Fmw, Gs^Fp, Gs^Fdw, Aa^Fdw, Gs, Gs, Hh^Fmw, Hh, Ms, Ms, Mm, Mm^Xm, Mm^Xm
Mm^Xm, Ms^Xm, Ms^Xm, Ms, Ms, Ms, Ms, Ms, Ms, Hh, Ha^Fpa, Gs^Fp, Aa^Fda, Gs, Hh, Ha, Ms, Ms, Mm, Mm, Wog, Wwg, Mm, Mm, Mm, Wwg, Ss, Ha^Fpa, Gs, Gs, Aa, Aa^Fp, Aa^Fp, Aa^Fdw, Gs^Fdw, Gs^Fdw, Gs^Fmw, Gs^Fmw, Gs^Fmw, Gs^Fp, Aa^Fp, Gs^Fdw, Gs^Fp, Gs^Fp, Gs^Fmw, Ha^Fmw, Hh, Ha^Fpa, Ha^Fda, Mm, Ms, Mm^Xm
Mm^Xm, Mm^Xm, Ms^Xm, Mm^Xm, Mm^Xm, Ms, Ms, Ms, Ha, Ha^Fpa, Hh, Aa, Gs^Fp, Ha^Fda, Mm, Mm, Ms, Ms, Mm^Xm, Wog, Ms^Xm, Mm^Xm, Ms^Xm, Mm^Xm, Mm^Xm, Mm, Ms, Ha^Fpa, Ha^Fpa, Gs, Gs, Gs^Fmw, Gs^Fmw, Gs^Fp, Aa^Fdw, Gs^Fmw, Aa^Fmw, Aa^Fmw, Aa, Aa^Fdw, Gs^Fp, Gs^Fp, Gs^Fmw, Gs^Fp, Gs^Fp, Gs^Fmw, Hh, Ha^Fpa, Ha^Fda, Ms, Ms, Gs
Mm^Xm, Mm^Xm, Mm^Xm, Mm^Xm, Mm^Xm, Mm^Xm, Mm, Ms, Gs, Hh, Gs, Gs^Fp, Gs, Ha, Mm, Mm, Gs, Mm^Xm, Mm^Xm, Mm^Xm, Mm^Xm, Ms^Xm, Mm^Xm, Mm^Xm, Mm^Xm, Mm, Gs, Gs, Ha, Gs, Gs, Gs, Gs, Gs^Fmw, Gs^Fmw, Aa^Fmw, Gs^Fmw, Aa, Gs^Fp, Gs, Gs, Gs^Fmw, Gs, Gs^Fmw, Gs, Gs^Fp, Gs, Ha, Gs, Ha, Gs, Mm
