border_size=1
usage=map

Ai, Ww, Ww, Ww, Ai, Ha^Fpa, Aa^Fpa, Aa^Fpa, Aa^Fpa, Aa^Fpa, Aa^Fpa, Ha, Aa^Fpa, Aa^Fpa, Aa^Fpa, Ha^Fpa, Aa^Fpa, Ha^Fda, Ss, Aa, Aa, Aa, Ha, Aa^Fpa, Aa^Fpa, Aa^Fpa, Aa^Fpa, Ha^Fma, Ha, Ha, Aa^Fpa, Aa^Fpa, Aa^Fpa, Ha^Fpa, Ha^Fpa, Aa, Aa^Fpa, Ha, Aa^Fpa, Aa, Ha^Fda, Ha, Ha^Fma, Ha^Fma, Aa^Fma, Ha, Ha^Fma, Ha, Aa^Fda, Aa^Fda, Ha, Aa, Ha, Aa, Ha
Aa^Fma, Ai, Ai, Ww, Ww, Ai, Aa^Fpa, Aa^Fpa, Aa^Fpa, Aa^Fpa, Aa^Fpa, Aa^Fpa, Aa^Fpa, Aa^Fpa, Ha^Fpa, Aa^Fpa, Aa^Vea, Ha^Fpa, Sm, Ss, Aa, Aa^Fda, Aa, Aa^Fpa, Aa^Fpa, Ha^Fpa, Aa^Fpa, Aa^Fpa, Ha^Fpa, Aa, Aa^Fpa, Ha^Fpa, Ha^Fpa, Aa^Fpa, Ha^Fpa, Aa^Fpa, Aa^Fda, Ha^Fma, Ha, Aa, Ha, Ha^Fma, Ha^Fma, Ha^Fma, Ha^Fda, Ha^Fda, Aa^Fma, Ha^Fma, Ha^Fma, Ha, Aa, Aa, Ha, Aa^Fma, Aa^Fda
Aa^Fpa, Ai, Ai, Ww, Ww, Ww, Ai, Aa^Fpa, Aa^Fpa, Aa^Fpa, Aa^Fpa, Aa^Vea, Aa^Fpa, Ha^Fpa, Cv, Aa^Fpa, Ha^Fpa, Ha^Fpa, Aa^Fpa, Aa^Fpa, Ha^Fpa, Aa^Fpa, Aa^Fpa, Aa^Fpa, Ha^Fpa, Ha^Fpa, Ha^Fpa, Aa^Fpa, Ha^Fpa, Ha^Fpa, Ha^Fpa, Ha^Fpa, Ha^Fpa, Ha^Fpa, Aa^Fpa, Ha^Fpa, Ha^Fpa, Aa^Fda, Aa^Fpa, Aa^Fda, Ha, Aa, Aa^Fma, Ha^Fma, Ha^Fpa, Ha^Fma, Ha, Ha^Fma, Aa^Fda, Aa^Fma, Ha^Fma, Ha^Fda, Ha^Fpa, Ha, Ha^Fma
Aa^Fpa, Aa^Fpa, Ai, Ai, Ww, Ww, Ww, Ha^Fma, Aa^Fpa, Aa^Fpa, Aa^Fda, Aa^Fpa, Cv, Cv, Cv, Cv, Aa^Fpa, Aa^Fpa, Ha^Fpa, Ha^Fpa, Aa^Fpa, Aa^Fma, Aa^Fpa, Aa^Fpa, Ha^Fpa, Ha^Fma, Ha^Fpa, Aa^Fpa, Ha^Fpa, Aa^Fpa, Ha^Fpa, Aa^Fpa, Ha^Fpa, Aa, Ha, Ha^Fma, Ha, Aa, Aa, Aa, Ha, Aa^Fma, Ha, Ha, Aa^Fda, Aa, Aa, Aa^Fma, Ha^Fda, Ha^Fma, Aa, Aa^Fma, Ha^Fda, Ha, Ha^Fda
Aa^Fpa, Aa^Fpa, Aa^Fpa, Ai, Ai, Ww, Ww, Ai, Aa^Fpa, Aa^Fpa, Aa, Cv, Cv, 1 Kv, Cv, Cv, Ha, Aa^Fpa, Ha^Fpa, Aa^Vea, Aa^Fpa, Aa^Fpa, Aa^Fpa, Ss, Aa^Fpa, Ha^Fpa, Ha^Fpa, Ha^Fma, Aa^Fpa, Ha^Fpa, Aa^Fpa, Ha, Ha, Ha^Fda, Aa^Fpa, Aa, Aa^Fma, Aa, Aa, Ha, Aa, Aa, Aa^Fda, Ha^Fpa, Ha, Aa^Fma, Ha^Fma, Ha^Fma, Aa^Fpa, Aa^Fda, Aa, Ha^Fda, Ha^Fpa, Ha^Fma, Ha
Aa^Fpa, Aa^Fpa, Aa^Fpa, Aa^Fpa, Ai, Ww, Ai, Ai, Ai, Aa^Vea, Aa, Cv, Cv, Cv, Ss, Ha^Fpa, Aa^Fma, Aa, Ha^Fma, Aa^Fda, Aa^Fma, Aa^Fda, Ha^Fpa, Ss, Ss, Ha^Fpa, Ss, Aa^Fpa, Ha^Fda, Ha^Fpa, Ha, Aa, Ha, Ha^Fpa, Aa^Fma, Ha^Fpa, Ha, Ha, Ha^Fda, Aa, Ha, Ha, Aa, Ha, Aa, Aa, Ha, Aa, Ha^Fda, Ha, Ha^Fma, Ha, Ha, Aa, Aa^Fda
Aa^Fpa, Aa^Fpa, Aa^Fpa, Ha^Fpa, Ai, Ai, Ww, Ww, Ww, Aa^Fda, Aa, Aa, Ha, Ha^Fpa, Ha^Fpa, Ss, Ss, Ss, Aa, Ss, Aa, Aa^Fda, Aa, Aa^Fpa, Ha^Fpa, Ss, Ha, Aa^Fda, Ha, Ha^Fda, Ha^Fma, Aa^Fpa, Aa^Fpa, Ha, Aa, Aa^Fda, Ha^Fpa, Ha^Fma, Aa, Ss, Aa, Ha, Aa, Ha, Aa, Ha, Aa, Ha, Ha, Aa^Fda, Ha, Aa, Ha, Ha^Fma, Aa^Fma
Aa^Fpa, Aa^Fpa, Aa^Fpa, Aa^Fpa, Aa^Fpa, Ai, Ai, Ww, Ai, Ai, Ai, Aa, Aa^Fma, Aa, Aa^Fda, Rb, Rb, Ha^Fpa, Ss, Ss, Ha^Fda, Aa, Ha^Fda, Aa^Fma, Ss, Ss, Ha^Fma, Aa^Fma, Ha, Aa, Ha, Aa, Ha, Ha, Ha, Aa, Ha^Fpa, Ha, Aa, Ss, Ss, Ha^Fma, Ha, Aa, Ha, Ha^Fma, Ha^Fda, Aa, Ha^Fma, Ha, Aa, Ha^Fpa, Ha^Fpa, Ha^Fma, Ha^Fpa
Ha^Fpa, Ha^Fpa, Aa^Fma, Ha^Fma, Aa^Fpa, Ha^Fpa, Ai, Ww, Ww, Ww, Ai, Ha, Aa, Aa, Ha^Fma, Ha^Fpa, Aa, Ss, Ss, Ss, Ss^Vhs, Aa, Ha, Ss, Ss, Aa, Aa, Aa, Aa, Aa, Ha^Fma, Aa^Fpa, Aa, Aa, Aa, Aa, Ha, Aa, Ss, Ss, Ha, Ha, Ha, Aa^Fpa, Aa, Ha, Aa, Ha, Ha^Fda, Ha, Aa, Aa^Fma, Ha, Ha, Ha
Aa^Fpa, Aa^Fpa, Ha^Fpa, Aa^Fpa, Aa^Fpa, Aa^Fpa, Aa^Fpa, Ww, Ai, Ww, Ww, Aa, Ss, Rb, Ss, Aa^Fda, Ha^Fpa, Rb, Aa, Aa^Fpa, Ss, Ss, Aa^Fda, Ss, Aa, Ss, Ha, Ha^Fda, Aa^Fma, Aa, Aa, Aa, Aa, Ha, Ha, Ha, Aa, Ha, Ha, Ha, Ha, Ha, Ha, Ha, Ha, Ha, Ha, Ha^Fpa, Ha, Ha, Ha^Fpa, Ha^Fpa, Aa, Ha, Ha
Aa^Fpa, Aa^Fpa, Ha^Fpa, Aa^Fpa, Aa^Fpa, Aa^Fpa, Aa, Ww, Ai, Ai, Ww, Ss, Aa, Aa^Fda, Rb, Aa, Aa, Rb, Aa, Ss, Aa^Fma, Ha^Fpa, Ha^Fda, Aa, Ss, Ss, Ha, Ha^Fda, Aa, Aa, Aa, Aa, Aa, Aa, Aa, Aa, Aa, Ss, Aa, Aa, Ha, Ha, Aa, Ha, Ha, Ha, Ha, Aa, Ha, Ha^Fda, Ha, Ha, Aa, Ha, Ha^Fda
Aa^Fpa, Aa^Fda, Aa^Fpa, Aa^Fpa, Aa^Fma, Aa, Aa^Fma, Ai, Ai, Ai, Ww, Ai, Aa^Fma, Sm, Ss, Aa, Aa, Ss, Ss, Aa, Aa, Aa^Fma, Sm, Ss, Ss, Ss, Aa, Ss, Aa, Aa, Ss, Ss, Ss, Aa, Aa, Aa, Ss, Ss, Ha^Fpa, Aa, Ha, Aa, Ha, Aa, Ha, Ha, Aa, Aa, Ha, Aa, Aa, Ha, Ha, Ha^Fpa, Aa^Fma
Aa^Fpa, Aa^Fpa, Ha^Fpa, Aa^Fpa, Ha^Fpa, Aa^Fda, Aa, Aa, Ww, Ww, Ww, Ai, Ha, Ha^Fpa, Aa, Ha^Fpa, Ss, Rb, Ss^Vhs, Aa, Aa, Rb, Ss, Aa, Ss, Aa, Ss, Ss, Ss, Aa, Aa, Aa, Ss, Aa, Ss, Aa, Ha^Fda, Aa, Aa, Aa, Aa, Ha^Fma, Ha^Fma, Aa^Fpa, Ha, Aa, Ha^Fpa, Ha, Ha, Ha, Ha, Aa, Ha^Fpa, Ha^Fpa, Ha
Aa^Fpa, Aa^Fpa, Aa^Fda, Aa^Fpa, Aa^Fda, Aa^Fda, Ai, Ai, Ww, Ww, Ai, Ha, Aa, Ha, Aa, Ss, Ha, Ss, Ha, Rb, Aa, Rb, Aa, Rb, Rb, Ss, Ss^Vhs, Aa, Ha, Aa, Aa^Fda, Ss, Aa, Ss, Ha^Fma, Ss, Aa, Aa, Ha, Aa, Aa, Ha, Ha, Aa, Ha, Ha, Ha^Fpa, Ha^Fpa, Ha, Ha^Fpa, Ha^Fpa, Aa^Fpa, Ha, Ha^Fpa, Ha^Fda
Aa^Fpa, Ha^Fpa, Aa^Fda, Aa^Fpa, Aa, Aa^Fda, Ai, Ww, Ww, Ww, Aa, Aa, Aa, Aa, Aa^Fpa, Ss, Ss, Ha, Ss, Ha^Fpa, Rb, Aa, Rb, Ss, Rb, Ss, Ss, Sm, Ss, Ss, Ss, Ha, Ha, Ss, Ss, Aa, Ha, Aa, Aa, Aa, Ss, Aa, Aa, Aa, Ha, Ha^Fpa, Ha, Ha^Fpa, Ha, Ha, Ha, Ha, Ha^Fpa, Ha, Ha
Aa^Fpa, Ha^Fpa, Aa^Fpa, Aa^Fpa, Aa, Aa^Fda, Ai, Ai, Ww, Ww, Ww, Ww, Ai, Aa, Aa, Aa, Ha^Fpa, Ss, Ss, Ss, Ha^Fda, Ss, Rb, Aa, Ss, Rb, Chs, Sm, Chs, Ss, Sm, Ss, Aa^Fma, Ss, Ss, Aa, Ss, Ss, Ss, Ha, Ha, Ha, Ss, Ha, Ha, Ha, Ha, Ha, Ss, Ha, Ha, Aa^Fda, Ha, Ha, Ha
Aa^Fpa, Aa^Fpa, Ha^Fpa, Aa^Fpa, Aa^Fda, Aa^Fpa, Aa, Ai, Ai, Ww, Ww, Ww, Ai, Aa, Aa, Aa^Fpa, Aa^Fma, Ss, Ss, Ha, Ss, Ss, Aa^Fma, Rb, Chs, Ss, Chs, Chs, Chs, Chs, Chs, Chs, Sm, Ss, Ss, Aa, Aa, Aa, Aa, Aa, Aa, Aa, Aa, Aa, Ss, Ha^Fpa, Ss, Ss, Aa, Ha^Fma, Ha, Ha, Aa^Fda, Aa, Ha
Aa^Fpa, Aa^Fpa, Aa^Fpa, Aa, Aa, Aa, Aa^Fma, Ai, Ai, Ww, Ai, Ww, Ww, Ai, Ai, Ha, Ha, Aa, Ss, Aa, Sm, Ha, Chs, Chs, Chs, 3 Khs, Chs, Ss, Ss, Sm, Ss, Aa, Ss, Aa, Aa, Aa, Aa, Ha^Fma, Aa, Ss, Ha, Ss, Ss, Ha, Chr, Chr, Chr, Ss, Ha, Ha^Fpa, Ha^Fda, Ha^Fpa, Aa, Ha, Ha^Fda
Aa^Fpa, Aa^Fpa, Aa^Fpa, Aa^Fpa, Aa^Fpa, Aa, Ha^Fda, Aa, Aa^Fpa, Ai, Ai, Ww, Ww, Ww, Ai, Ai, Aa, Ha^Fma, Sm, Sm, Chs, Chs, Ss, Ss, Ss, Ss, Sm, Rb, Rb, Aa, Aa, Ss, Aa, Ss, Aa, Aa, Aa, Aa, Aa, Aa, Ha, Aa, Ha, Ss, Aa, Chr, Chr, Ha, Ha, Ha, Aa^Fma, Ha^Fda, Aa, Ha, Aa^Fpa
Aa^Fpa, Aa^Fma, Aa^Fpa, Aa^Fpa, Aa^Fpa, Ha^Fpa, Aa^Fpa, Ha^Fma, Ha, Ai, Aa^Fda, Ai, Ww, Ww, Ww, Ai, Ai, Aa^Fda, Sm, Ss, Chs, Ss, Sm, Ha^Fpa, Ha, Ss, Ha, Ss, Ha, Aa, Ha^Fda, Aa, Aa, Ss, Ss, Ha, Aa, Ha^Fma, Ha, Aa^Fpa, Aa, Ha, Aa^Fpa, Ss, Rb, Chr, Ha^Fma, Chr, Ha, Ha, Aa, Aa, Ha^Fpa, Ha, Ha^Fma
Aa^Fpa, Aa^Fpa, Aa^Fpa, Ha^Fpa, Ha^Fpa, Aa^Fpa, Aa, Aa, Ha, Ha^Fma, Aa, Aa^Fda, Ai, Ww, Ai, Ai, Ww, Ss, Sm, Sm, Ss, Sm, Ss, Ss, Ss, Aa, Ss, Ss^Vhs, Rb, Aa, Aa^Fma, Ha, Rb, Ha, Ha^Fda, Aa, Ss, Ha, Ha, Ha^Fpa, Aa, Aa, Aa^Fda, Aa^Fpa, Rb^Vhr, Rb, Aa, 4 Khr, Chr, Ha, Ha, Ha^Fda, Ha, Ha, Ha
Aa^Fpa, Aa^Fpa, Ha^Fpa, Aa^Fpa, Aa^Fpa, Aa^Fpa, Aa, Aa, Aa^Fma, Aa, Ha, Ha^Fpa, Ha, Ww, Ww, Ww, Ww, Sm, Aa, Aa, Ss, Ss, Aa, Ha, Aa^Fda, Aa, Ss, Aa, Aa, Ha, Ha, Aa, Aa, Rb, Rb, Ha, Aa, Aa, Aa^Fma, Aa, Aa^Fma, Aa^Fda, Ss, Rb, Rb, Rb, Rb, Chr, Chr, Chr, Aa, Aa^Fda, Aa^Fda, Aa^Fma, Ha
Aa, Ha^Fpa, Aa, Aa^Fpa, Aa, Aa^Fpa, Aa^Fpa, Ha, Ha^Fda, Aa, Aa^Fpa, Aa^Fda, Aa^Fma, Ai, Ww, Ww, Ww, Ww, Aa, Ss, Ha, Ss, Aa, Aa, Aa, Ss, Ss, Rb, Aa, Ha^Fpa, Ha, Ha^Fma, Aa, Rb, Ha^Fda, Aa, Ha, Aa, Aa, Aa^Fma, Ss, Aa^Fma, Ss, Aa^Fma, Rb, Rb, Aa^Fda, Rb, Rb, Chr, Chr, Aa^Fpa, Aa^Fpa, Ha, Ha^Fpa
Aa^Fpa, Aa^Fpa, Aa^Fpa, Aa, Aa, Aa, Aa, Aa, Aa^Fma, Aa, Aa, Aa, Aa, Ha, Aa^Fpa, Ai, Ai, Ww, Ww, Ha, Aa, Aa, Aa, Ha, Aa, Ss, Aa^Fda, Rb, Rb, Aa, Ha, Ha, Ha, Aa, Aa, Aa^Fda, Ha^Fpa, Aa, Aa, Aa, Aa^Fpa, Ss, Rb, Aa, Aa, Ha, Rb, Rb, Ha, Chr, Aa, Aa, Aa^Fma, Ha, Ha^Fda
Aa^Fpa, Aa^Fpa, Aa^Fpa, Ha, Aa^Fma, Aa, Aa, Aa, Aa, Ha, Ha, Aa, Ha^Fpa, Aa^Fpa, Aa^Fda, Ww, Ww, Ww, Ww, Aa, Aa, Aa, Aa, Aa, Aa^Fda, Ss, Rb, Rb, Aa, Ha, Cea, Ha, Aa, Aa, Aa, Ha, Cea, Ha, Ha, Ha^Fda, Rb, Rb, Aa, Aa, Aa, Aa, Rb, Aa, Aa, Rb, Aa, Aa, Aa, Aa^Fpa, Aa^Fda
Aa^Fpa, Aa^Fpa, Aa^Fpa, Aa^Fpa, Aa^Fma, Aa, Aa, Aa, Aa, Aa, Aa, Ha, Aa, Aa, Ha^Fma, Ai, Ai, Ai, Ww, Ai, Ha, Aa^Fda, Ha^Fma, Ha, Aa^Fma, Aa, Aa^Fma, Rb, Rb, Ha, Cea, Cea, Ha, Ha^Vct, Ha, Aa, Ha^Vct, Cea, Aa, Rb, Ha, Aa, Ha^Fda, Ha^Fma, Ha^Fpa, Rb, Aa, Rb, Ha^Fpa, Rb, Aa^Fma, Aa^Fpa, Ha, Ha, Ha
Aa^Fpa, Aa^Fpa, Ha^Fpa, Aa^Fpa, Ha^Fma, Aa^Fma, Aa, Aa, Aa, Ha, Ha, Ha^Fpa, Aa, Aa, Ha^Fda, Aa^Fma, Ai, Ai, Ww, Ww, Ww, Ha^Fpa, Aa, Aa^Fda, Aa^Fma, Aa^Fma, Aa^Fda, Rb, Rb, Aa^Fpa, Rb, Rb, Cea, Ha, Cea, Aa, Cea, Ha^Fda, Cea, Aa, Cea, Ha, Ha^Fpa, Aa, Ha^Fda, Ha^Fma, Rb, Rb, Rb, Ha, Aa, Ha, Ha, Ha, Ha
Aa^Fpa, Aa^Fpa, Aa, Ha, Aa^Fpa, Aa, Aa, Aa, Aa, Aa, Aa, Aa^Fda, Aa, Ha, Aa, Aa^Fma, Ai, Ai, Ww, Ww, Ai, Ai, Aa^Fma, Ha^Fma, Aa, Aa, Aa, Aa, Rb, Aa, Cea, Cea, Cea, Cea, 2 Kea, Cea, Cea, Cea, Cea, Aa^Fpa, Cea, Cea, Aa^Fpa, Ha, Ha, Aa, Ha, Rb^Vhcr, Rb, Rb, Aa, Ha, Aa, Ha^Fda, Ha
Aa^Fpa, Aa^Fpa, Ms, Aa^Fda, Ms^Xm, Aa, Ha^Fpa, Aa^Fma, Ha^Fma, Aa, Aa, Aa, Aa^Fda, Ha, Ha, Aa^Fma, Aa, Ai, Ai, Ww, Ww, Ai, Ww, Aa^Fpa, Rb^Vhhr, Aa, Aa^Fpa, Ha, Cea, Rb, Rb, Cea, Cea, Cea, Cea, Cea, Cea, Cea, Ha, Ha, Aa, Aa, Aa, Ha^Fpa, Aa^Fma, Ha^Fda, Ha^Fda, Aa^Fda, Aa, Ha, Aa^Fda, Ha, Ms, Ha, Ha
Ha, Ms, Ms, Ms^Xm, Aa, Aa, Aa, Ha^Fma, Ha^Fma, Aa, Ha^Fpa, Aa, Aa, Aa^Fda, Aa, Aa, Aa, Ha^Fpa, Aa^Fpa, Ai, Ww, Ww, Ai, Ai, Rb, Rb, Rb, Cea, Cea, Aa, Ha^Vct, Ha, Rb, Cea, Ha, Cea, Ha, Cea, Ha^Vct, Ha, Cea, Aa, Ha^Fma, Ha, Ha^Fpa, Ha, Ha^Fda, Rb, Aa, Ha, Ms, Ms, Ms, Ha, Ms
Ms, Ms, Ms^Xm, Ms^Xm, Aa, Ms^Xm, Aa, Ha^Fma, Ha^Fda, Aa^Fpa, Aa, Ha, Aa^Fma, Aa, Aa, Ha, Ha, Ha^Fpa, Aa, Ai, Ww, Ww, Ww, Ww^Bw/r, Rb, Aa^Fda, Ha^Fma, Ha, Ha, Aa, Aa, Ha, Ha, Ha, Aa^Vct, Ha, Ha, Aa, Aa, Cea, Cea, Ha, Ha^Fma, Aa, Aa, Ha^Fma, Ha, Aa^Fda, Ha, Ms, Ms, Ms, Ms^Xm, Ms^Xm, Ms^Xm
Ms, Ms^Xm, Uu, Uu, Ms^Xm, Ms^Xm, Aa, Aa^Fpa, Ha^Fpa, Aa^Fpa, Aa^Fda, Ha^Fpa, Aa^Fda, Chr, Rb, Rb^Vhcr, Aa, Ha^Fpa, Ha, Aa^Fpa, Rb, Ai^Bw/r, Ai, Ww, Ai, Aa^Fda, Aa, Ha, Aa, Aa, Ha, Cea, Cea, Aa, Aa, Ha, Rb, Aa, Ha^Fda, Ha, Ha^Fma, Aa, Rb, Ha^Fda, Ha^Fma, Ha, Aa, Ha, Aa^Fpa, Ha, Ms, Ms, Ms^Xm, Ms, Ms^Xm
Ms, Ms^Xm, Ms^Xm, Uu, Ms^Xm, Ms^Xm, Aa, Aa, Aa, Aa, Ha, Ha, Aa, Chr, Chr, Rb, Ha^Fpa, Aa, Rb, Rb^Vhcr, Rb, Ww, Ai, Ai, Ai, Aa, Aa^Fpa, Aa, Aa, Ha, Ha, Ha, Aa^Fma, Aa, Rb, Rb, Ha^Fma, Rb, Rb, Ha^Fda, Ha^Fma, Ha, Ha^Fma, Rb, Rb, Ha, Ha^Fma, Chr, Ha, Ms, Ha, Ms, Ms, Ms^Xm, Ms
Ha, Ms, Ms, Ms^Xm, Ms, Ms, Ha, Aa^Fda, Ha, Ha, Aa^Fma, Aa, Aa, Chr, Chr, Chr, Chr, Rb, Aa^Fma, Rb, Aa^Fma, Ww, Ww, Ai, Ww, Ai, Aa^Fpa, Aa, Aa^Fma, Aa, Rb, Rb^Vhhr, Aa^Fpa, Rb, Rb, Aa, Aa, Aa^Fma, Ha^Fma, Ha, Aa, Ha, Ha, Aa, Rb, Aa^Fda, Chr, Chr, Aa, Aa, Ha, Ms, Ms^Xm, Ms^Xm, Ms^Xm
Ha^Fma, Ms, Ha, Ms, Ha, Ha, Ha, Ha, Aa^Fda, Aa^Fpa, Ha, Aa^Fpa, Aa^Fda, Chr, Chr, 7 Khr, Aa^Fda, Rb, Aa, Aa^Fma, Ha^Fma, Ai, Ww, Ww, Ai, Ai, Aa^Fma, Ha^Fma, Ha, Ha^Fpa, Aa, Rb, Aa^Fda, Rb, Rb, Rb, Rb, Rb, Aa, Rb, Rb, Rb, Ha, Rb, 5 Khr, Chr, Chr, Chr, Ha, Aa^Fda, Ms, Ha, Ms^Xm, Ms, Ms^Xm
Aa^Fda, Ms^Xm, Ms, Ms, Ha, Ha, Ha, Ha, Aa, Aa, Ha, Ha, Ha, Rb, Ha^Fma, Chr, Chr, Ha, Chr, Rb, Ha^Fma, Aa, Ai, Ww, Ai, Ww, Ha, Ha^Fpa, Aa^Fpa, Ha, Rb, Aa, Rb, Ha^Fpa, Ha^Fpa, Rb, Aa, Aa, Aa, Aa, Aa^Fpa, Aa, Ha, Chr, Chr, Chr, Rb, Ha, Ha, Ms, Ha, Ms, Ms, Ms^Xm, Ha^Fma
Ha^Fma, Ha, Ms^Xm, Ms, Ha, Ms, Ha, Ha, Aa, Ha, Ha, Aa, Ha, Aa, Ha, Chr, Chr, Chr, Rb^Vhcr, Rb, Aa, Aa, Ai, Ww, Ww, Ww, Ai, Chr, Chr, Chr, Chr, Ha, Rb, Ha^Fma, Rb, Rb^Vhcr, Aa, Aa, Rb, Ha, Rb, Aa, Chr, Chr, Chr, Chr, Ha, Ha, Ha, Ms, Ms, Ms, Ms, Ms, Ms
Aa^Fpa, Ms, Ms, Ms, Ms, Ha, Aa, Aa, Ms, Ha^Fma, Ha, Ha, Aa^Fda, Ha, Ha^Fpa, Rb, Aa, Rb, Aa, Rb, Aa, Ha, Ai, Ww, Ww, Ww, Ha, Ha^Fpa, Chr, Chr, Chr, 6 Khr, Chr, Chr, Rb, Aa, Rb, Ha, Rb, Rb^Vhcr, Aa, Rb, Chr, Chr, Aa^Fma, Ha, Aa^Fpa, Ha, Ms, Ha, Ms, Ms, Ms^Xm, Ms^Xm, Ms^Xm
Ms, Ms, Ms^Xm, Ms, Ha, Ha, Ha, Aa^Fpa, Ms, Ha, Aa, Ha, Ha, Ha, Ha, Ha, Aa, Ha, Ha, Aa, Ha, Ai, Ww, Ww, Ww, Ww, Ai, Aa, Ha^Fma, Chr, Ha, Chr, Ha, Chr, Ha, Aa, Ha^Fda, Rb, Rb, Rb, Ha, Rb, Ha, Ha, Ha, Ha^Fda, Aa^Fpa, Ms, Aa, Ms, Ms, Ms, Ms^Xm, Ms, Ms^Xm
Ms, Ha, Ms, Ms, Ms^Xm, Ms, Ms, Aa, Aa, Aa^Fma, Aa, Aa, Ha, Ha, Ha, Ha^Fda, Ha^Fpa, Ha, Aa, Ha^Fma, Ha, Aa, Ww, Ww, Ww, Ai, Ww, Ha, Aa, Aa, Aa, Rb, Ha, Ha, Ms, Ha^Fda, Aa, Ha, Aa^Fpa, Ha^Fma, Ms, Ha, Aa^Fma, Ha, Ha, Aa, Ha, Ms, Ms, Ms, Ms, Ms, Ms, Ms^Xm, Ms
Ms, Ms, Ms, Ha, Ha, Ha, Ms, Ms, Ms, Aa, Ha^Fda, Aa^Fpa, Ha, Ms, Ha, Ms, Ms, Ha, Ha^Fma, Aa, Aa, Aa^Fpa, Ai, Ww, Ww, Ww, Aa^Fda, Ha^Fpa, Ms, Ha^Fma, Ha, Ha, Ms, Ha, Ms, Ha, Ms, Ms, Ms, Ha^Fda, Ms, Ha, Ms, Ha, Ha, Ms, Ms, Ms, Ms, Ms, Ms, Ms, Ms^Xm, Ms^Xm, Ms^Xm
Ms^Xm, Ms^Xm, Ms^Xm, Ms^Xm, Ha, Ha, Ms, Ms, Ha, Ms, Ms, Ha, Ms, Ms, Ms, Ms, Ms, Aa, Ha^Fpa, Ha, Ha, Aa, Aa, Ww, Ai, Aa^Fpa, Ms, Ms, Ms, Ha, Ms, Aa^Fma, Ms, Ms, Ms, Ms, Ms, Ms, Ms, Ms, Ha, Ms, Ha, Ha, Aa, Ms, Ms, Ms, Ms, Ms, Ms^Xm, Ms, Ms^Xm, Ms^Xm, Ms^Xm
Ms^Xm, Ms, Ms^Xm, Ms, Ms, Ms, Ms, Ms, Ms, Ms, Ms, Ms, Ms, Ms, Ms, Ms, Ms, Ms, Ms, Ms, Ha, Aa, Ha, Ai, Ai, Ms, Ms, Ms, Ms^Xm, Ms, Ms^Xm, Ms, Ms^Xm, Ms, Ms, Ms, Ms, Ha, Ms, Ms, Ms, Ms, Ms, Ms, Ms^Xm, Ms, Ms^Xm, Ms, Ms^Xm, Ms^Xm, Ms^Xm, Ms^Xm, Ms^Xm, Ms^Xm, Ms^Xm
Ms^Xm, Ms^Xm, Ms, Ms, Ms, Ms^Xm, Ms^Xm, Ms, Ha, Ms, Ms, Ms, Ms, Ms, Ha, Ms, Ms, Ms, Ms, Ms, Ms, Ms, Ms, Ai, Ww, Ha, Ms, Ms^Xm, Ms, Ms^Xm, Ms^Xm, Ms^Xm, Ms^Xm, Ms^Xm, Ms, Ms, Ms^Xm, Ms^Xm, Ms^Xm, Ms, Ms^Xm, Ms^Xm, Ms^Xm, Ms^Xm, Ms, Ms^Xm, Ms, Ms^Xm, Ms, Ms^Xm, Ms^Xm, Ms^Xm, Ms^Xm, Ms^Xm, Ms^Xm
Ms, Ms, Ms, Ms, Ms, Ms, Ms, Ms, Aa^Fpa, Ms, Ms, Ms, Ha, Ms, Ms, Ms, Ms, Ha, Ms, Ha, Ms, Ha, Ms, Ww, Ww, Ms, Ha, Ms^Xm, Ms^Xm, Ms^Xm, Ms^Xm, Ms^Xm, Ms^Xm, Ms^Xm, Ms, Ms, Ms^Xm, Ms, Ms^Xm, Ha^Fma, Ms^Xm, Ms, Ms^Xm, Ms^Xm, Ms^Xm, Ms^Xm, Ms^Xm, Ms^Xm, Ms^Xm, Ms^Xm, Ms^Xm, Ms^Xm, Ms^Xm, Ms^Xm, Ms^Xm
