border_size=1
usage=map

Ha, Ms, Ha, Ms, Ha, Ha, Ha, Ms, Ms, Ms, Ms, Ms, Ms, Ms, Ms, Ha, Ms, Ha, Ha, Aa, Aa
Ms, Ms, Ms, Ms, Ms, Ms, Koa^Qov, Ms, Ha, Ha, Aa, Ha, Aa, Ms, Koa^Qov, Ms, Ha, Ms, Ms, Ms, Ha
Ms, Ms, Ms, Ha, Ha, Aa, Aa, Aa, Aa^Qov, Aa, Rp, Aa, Aa^Qov, Aa, Aa, Ha, Aa, Ha, Ha, Ha, Ms
Ms, Ms, Ms, Ha, Aa, Ha, Rb, Rb, Aa, Aa, Aa, Rb, Ur, Ur, Aa, Aa, Ha, Aa, Ha, Ms, Ha
Ha, Ms, Ha, Aa, Rp^Qov, Aa, Aa, Rb, Rp, Rp, Aa, Rp, Aa, Rp, Rb, Rp, Aa^Qov, Ha, Aa, Ha, Ms
Ha, Ms, Ms, Aa, Rp, Aa, Ur, Aa, Aa, Rp, Wot, Aa, Rb, Rp, Ur, Aa, Rp, Ha, Ms, Ha, Ha
Ms, Koa^Qov, Ms, Aa, Rp, Ur, Ur, Rb, Ur, Rp, Rp, Rp, Aa, Rp, Aa, Rp, Rp, Aa, Ms, Koa^Qov, Aa
Ha, 1 Ms, Ha, Aa, Aa^Qov, Aa, Aa, Aa, Aa, Aa, Rb, Aa, Aa, Rp, Rb, Aa, Aa^Qov, Ha, Ha, Ha, Ms
Ha, Ha, Aa, Ha, Aa, Aa, Aa, Aa, Aa, Aa, Ur, Rb, Aa, Ur, Rb, Aa, Ha, Aa, Ms, Ha, Ms
Ha, Ms, Ha, Ha, Ha, Aa, Aa, Rp, Rp^Qov, Aa, Aa, Aa, Aa^Qov, Rb, Aa, Ha, Ha, Ha, Ha, Ms, Ms
Ha, Ms, Ms, Ms, Ms, Koa^Qov, Ha, Aa, Aa, Aa, Aa, Aa, Aa, Aa, Ms, Koa^Qov, Ms, Ha, Ms, Ms, Ms
Ms, Ha, Ms, Ms, Ms, Ms, Ms, Ms, Ms, Ms, Ms, Ha, Ha, Ha, Aa, Ha, Ms, Ms, Ms, Ha, Ms
Ms, Ms, Ms, Ms, Ms, Ms, Ha, Ms, Ms, Ms, Ha, Ha, Ha, Ms, Ha, Ms, Ms, Ms, Ha, Ms, Ms
