border_size=1
usage=map

Md, Hhd, Md, Md, Mm, Gd, Re, Re, Re, Md, Md, Hhd, Md, Md, Md, Md, Hhd, Hhd, Hhd, Md, Md, Hhd, Md, Hhd, Hhd, Md, Hhd, Gd, Gd, Gd, Gd, Gd, Gd, Hhd^Fmf, Hhd^Fmf, Hhd^Fmf, Gd, Gd, Gd, Gd, Gd, Gd, Gll^Fmf, Gd, Gd, Gd
Md, Md, Md, Md, Mm, Hhd, Re, Re, Re, Hhd, Md, Md, Md, Hhd, Md, Hhd, Md, Hhd, Md, Md, Md, Hhd, Md, Hhd, Md, Md, Hhd, Hhd, Hhd, Gd, Gd, Gd, Gd, Gd, Gd, Hhd^Fmf, Hhd^Fmf, Hhd^Fmf, Gll^Fmf, Hhd^Fmf, Hhd^Fmf, Gd, Gd, Gll^Fmf, Gd, Gd
Md, Md, Md, Hhd, Hhd, Gd, Rd, Rd, Re, Hhd, Hhd, Md, Md, Md, Md, Md, Hhd, Hhd, Hhd, Md, Hhd, Md, Md, Hhd, Gd, Hhd, Hhd, Hhd, Hhd, Hhd, Hhd^Fmf, Hhd^Fmf, Hhd^Fmf, Hhd^Fmf, Gd, Hhd^Fmf, Gd, Hhd^Fmf, Gll^Fmf, Gd, Hhd^Fmf, Gd, Gd^Vo, Gll^Fdf, Gd, Gd
Md, Md, Md, Hhd, Hhd, Hhd, Re, Rd, Re, Hhd, Hhd, Hhd, Hhd, Md, Md, Gd, Gd, Hhd, Re, Gd, Gd, Gd, Gd^Gvs, Hhd, Hhd, Gd, Hhd, Hhd, Hhd^Fmf, Hhd^Fmf, Hhd, Hhd^Fmf, Hhd^Fmf, Hhd^Fmf, Gd^Es, Hhd^Fmf, Hhd^Fmf, Hhd^Fmf, Gd, Gll^Fmf, Gd, Hhd^Fmf, Gd, Gll, Gll^Fmf, Gd
Md, Md, Md, Hhd, Hhd, Gd, Re, Re, Re, Gd, Gd, Hhd, Hhd, Md, Wwg, Wwg, Re, Gd, Gd, Hhd, Gd^Gvs, Gd^Gvs, Gd^Gvs, Gd^Gvs, Gd^Gvs, Gd, Gd, Re, Re, Hhd^Fmf, Hhd^Es, Hhd^Fmf, Hhd^Fmf, Hhd^Fmf, Gll^Fmf, Gd, Gll^Fmf, Hhd^Fmf, Hhd^Fmf, Gll^Fmf, Gll^Fmf, Hhd^Fmf, Gd, Gd, Gll^Fmf, Gd
Md, Hhd, Md, Hhd, Hhd, Hhd, Re, Rd, Rd, Gd^Es, Gll^Fmf, Gd, Gd, Wwg, Wog, Wwg, Gd, Gd^Es, Gd^Gvs, Gd^Gvs, Gd^Wm, Gd^Gvs, Gd^Gvs, Gd^Gvs, Gd^Wm, Gd, Gd, Gd, Gd, Gd, Gd, Gd^Vo, Gd, Gll^Fmf, Gd, Gd, Gd, Gll, Hhd^Fmf, Gd, Gd, Hhd^Fmf, Hhd^Es, Gd, Gll^Fmf, Gd
Hhd, Md, Md, Hhd, Hhd, Hhd, Gd, Rd, Rd, Gll^Fmf, Gll, Gll^Fmf, Gd, Wwg, Wwg, Wwg, Gd, Gd, Gd^Gvs, Gd^Gvs, Gd^Gvs, Gd^Gvs, Gd^Gvs, Gd^Gvs, Gd, Gd^Gvs, Gd, Gd, Gd, Gd, Gd, Gd, Gd, Hhd^Fmf, Hhd^Fmf, Hhd^Fmf, Hhd^Fmf, Gll^Fmf, Hhd^Fmf, Gd, Gd^Vo, Gd, Gd, Gd, Gll^Fmf, Gd
Hhd, Md, Md, Md, Hhd, Gd, Gd^Vo, Re, Rd, Rd, Rd, Rd, Rd, Gd, Wwg, Gd, Gd, Gd, Gd, Gd^Gvs, Gd^Gvs, Gd^Gvs, Gd, Gd, Hhd, Gd, Co, Gd, Hhd, Gd, Gll^Fmf, Gd, Gd, Hhd^Fmf, Gll^Fmf, Re, Gll^Fmf, Gll^Fmf, Gll^Fmf, Gd, Gd^Es, Gd, Gll^Fmf, Gll^Fmf, Gd, Gd
Md, Md, Md, Md, Hhd, Hhd, Re, Rd, Re, Re, Co, Co, Co, Re, Re, Gd, Gd, Gd^Vo, Rd, Gd^Gvs, Gd, Gd, Md, Md, Md, Hhd, Hhd, Gd, Gd, Gd, Gll^Fdf, Gd, Gd, Gd, Gd, Gd, Gll, Gll^Fmf, Gll, Gll^Fmf, Gll, Gd, Gll^Fmf, Gd, Md, Md
Md, Md, Md, Md, Md, Hhd, Re, Rd, Re, Gd, Co, 1 Ko, Co, Rd, Rd, Re, Re, Re, Rd, Gd^Gvs, Gd, Md, Md, Md, Md, Md, Hhd, Gd, Gd, Gll^Fmf, Gd, Gll^Fmf, Gll^Fmf, Gd^Es, Gll^Fmf, Gd, Gd, Gd, Re, Gll^Fmf, Gd, Gll^Fmf, Hhd, Gd^Es, Md, Md
Md, Hhd, Md, Md, Md, Hhd, Re, Re, Re, Gd, Re, Co, Re, Gd, Re, Rd, Re, Re, Re, Re, Gd^Gvs, Gd, Gd, Md, Md, Md, Hhd, Re, Gd, Hhd, Re, Gll^Fmf, Gll^Fmf, Gll^Fmf, Gll^Fmf, Hhd, Gll^Fmf, Gd, Gll^Fmf, Gd, Gd, Gd, Md, Md, Md, Md
Md, Md, Md, Md, Md, Gd, Re, Rd, Re, Gd, Re, Rd, Re, Re, Re, Gd^Vo, Rd, Rd, Rd, Re, Gd, Re, Gd, Hhd, Md, Md, Gd, Gd, Gll^Fmf, Gd, Gd, Gll^Fmf, Gll^Fmf, Gll, Gll, Gll^Fmf, Gll^Fmf, Re, Gll^Fdf, Re, Gll^Fmf, Gd, Gd, Md, Md, Md
Md, Hhd, Md, Md, Hhd, Hhd, Hhd, Rd, Rd, Gd^Vo, Rd, Rd, Rd, Rd, Rd, Rd, Md, Rd, Rd, Re, Gd, Hhd, Hhd, Md, Md, Hhd, Gll^Fmf, Gll^Fmf, Gd, Gd, Gd, Gll^Fmf, Gll^Fmf, Hhd^Fmf, Gd, Gd, Gll^Fmf, Gd, Gll^Fmf, Gll^Fmf, Gd, Gd, Re, Md, Md, Md
Md, Md, Hhd, Hhd, Md, Md, Md, Hhd, Hhd, Rd, Re, Re, Re, Re, Re, Md, Md, Md, Rd, Re, Re, Gd, Hhd, Md, Hhd, Hhd, Gll^Fmf, Gd, Gd, Gd, Gd, Gd, Gll^Fmf, Gll^Fmf, Gll^Fmf, Gll^Fmf, Gll^Fmf, Gd, Gd, Gd, Hhd, Gd, Hhd, Hhd^Fmf, Gd, Gd
Md, Md, Md, Md, Md, Md, Md, Md, Md, Md, Hhd, Gd, Gll^Fmf, Gd, Gd^Es, Gd, Gd, Md, Re, Rd, Rd, Co, Gd, Hhd, Gd, Gll^Fmf, Gll^Fmf, Gll^Fmf, Gll^Fmf, Gd, Gd^Es, Gll^Fmf, Gll^Fmf, Gll, Gll^Fmf, Gll^Fmf, Gd, Gd, Hhd, Gd, Gll^Fmf, Gd, Gll^Fmf, Gll^Fmf, Gd, Gd
Md, Md, Md, Md, Md, Gd, Re, Hhd, Hhd, Hhd, Hhd, Gll, Gll^Fmf, Gd, Gd, Re, Gd, Gd^Es, Hhd, Re, Re, Rd, Re, Gd, Gd, Gd, Gd, Gd, Gll^Fmf, Hhd, Gd, Gd, Gll, Gll^Fmf, Gll^Fmf, Gll^Fmf, Gd, Gd, Gll^Fmf, Gll^Fmf, Gd, Gll^Fmf, Gd, Gd, Wwg, Wwg
Md, Md, Md, Md, Md, Md, Md, Gd, Re, Hhd, Gd, Gd, Gll^Fmf, Gd, Gd, Gd, Hhd, Hhd, Hhd, Hhd, Re, Rd, Re, Hhd, Gd^Vo, Gll^Fmf, Hhd^Fmf, Gd, Gd, Gll^Fmf, Gll^Fmf, Hhd, Gll^Fmf, Gd, Gd, Gd, Gd, Gd, Gll^Fmf, Gd, Gd, Wwg, Wog, Wwg, Wog, Wog
Md, Md, Gd, Md, Md, Md, Md, Re, Gd, Gd, Gd, Gll^Fmf, Gd, Gd, Hhd, Gd, Re, Hhd, Gd, Gd, Gll, Re, Re, Re, Gll, Gll^Fmf, Gll^Fmf, Hhd^Fmf, Gd, Gll^Fmf, Gd^Es, Hhd, Re, Gd, Gd, Gd^Es, Gd, Gd, Wwg, Wwg, Wog, Wog, Wwg, Wog, Wwg, Hhd
Gd, Gd, Md, Md, Md, Md, Re, Gd, Gd, Re, Md, Gd, Gd, Hhd, Md, Hhd, Re, Gd, Gd, Gll^Fmf, Gll^Fmf, Gll, Re, Re, Re, Gll, Gll, Gll^Fmf, Gll^Fdf, Gd, Gd, Gd, Gd, Gd, Gd, Gd, Wwg^Bw\, Wwf, Wwg, Wwg, Wwg, Wwg, Gd, Wwg, Gd, Gd
Gd, Re, Gd, Md, Gd, Md, Gd^Es, Gd, Md, Md, Gd, Gd, Gd, Hhd, Md, Md, Hhd, Gd, Gd, Hhd^Fmf, Gll^Fmf, Hhd^Fmf, Gll^Fdf, Re, Rd, Re, Re, Gll^Fmf, Hhd, Gd, Gd, Hhd, Gd, Gd, Gd, Wwf, Wwg, Wwg^Bw\, Wwg^Bw\, Wwg, Wwg, Re, Hhd, Re, Gd, Gd
Gd, Gd, Gd, Gd, Gd, Gd, Gd, Gll^Fmf, Gd, Gd, Hhd, Gd, Gd, Hhd, Md, Hhd, Hhd, Gd, Hhd, Gd, Gll^Fmf, Gll^Fmf, Hhd^Fmf, Gll, Gll, Rd, Rd, Re, Re, Hhd, Gd, Gd, Gd, Re, Wwg, Wwg, Wwg, Wwg, Wwf, Re, Gd, Gd, Gd, Gd, Gd^Es, Gd
Gd, Hhd, Gd, Gd, Gd, Gd, Gd, Hhd, Gd, Gd, Md, Ko, Md, Hhd, Hhd, Md, Hhd, Gd, Gd, Re, Gd, Gll^Fmf, Gll^Fmf, Hhd^Fmf, Hhd^Fmf, Re, Re, Rd, Re, Re, Re, Re, Gd, Hhd, Wwg, Wwg, Wog, Wwg, Gd, Re, Hhd, Gd^Es, Gd, Gd, Hhd, Gd
Gd, Gd, Gll^Fmf, Gd, Gll^Fmf, Gll^Fmf, Gll^Fmf, Gd, Gd, Gll^Fmf, Hhd, Md, Hhd, Hhd, Hhd, Md, Hhd, Hhd, Gd, Gd, Re, Gll^Fmf, Hhd^Fmf, Gll^Fmf, Gll^Fmf, Gll^Fmf, Gd, Re, Rb, Rd, Re, Hhd, Wwg, Wwg, Wog, Wog, Wwg, Wwg, Gd, Gd, Re^Vct, Gd, Gd, Hhd, Hhd, Gd
Gd, Gd, Gll^Fmf, Gd, Gd, Hhd, Gll^Fmf, Gll^Fmf, Gll, Hhd^Fmf, Gd, Hhd, Hhd, Gd, Re, Hhd, Hhd, Hhd, Re, Gd, Gd, Gd, Gd, Gll^Fmf, Gd, Gd, Gd, Gll^Fmf, Gd, Rd, Rd, Wwf, Wwg, Wog, Wwg, Wwg, Wwg, Gd, Ce, Gd, Gd, Gd, Gd, Hhd, Gd, Hhd
Gd, Gd, Gd, Gll^Fmf, Gll^Fmf, Gll, Gd, Gd, Gll^Fmf, Gd, Gd^Vo, Gd, Gd, Gd, Gd, Gd, Hhd, Gd, Wwf, Gd, Wwf, Gd, Gd, Hhd, Hhd, Gd, Gd, Gd, Hhd, Re, Wwf, Wwg^Bsb\, Wwg^Bsb\, Wwg, Ce, Gd, Ce, 2 Ke, Ce, Ce, Hhd^Fdf, Hhd^Fdf, Hhd^Fdf, Gd, Gd, Gd
Gd, Gd, Gd, Gd, Gd, Gd, Gd, Gd, Md, Gd, Gd^Es, Gd^Es, Gd, Gd, Gd, Gd, Wwf, Wwf, Wwg, Wwg^Bw|r, Wwg, Wwf, Wwg, Wwf, Chs, Ss^Vhs, Gd, Hhd, Gd, Gd, Wwg, Wwf, Gd, Rd, Rd, Gd, Ce, Ce, Rd, Gd, Hhd^Fdf, Hhd^Fdf, Hhd^Fdf, Hhd^Fdf, Gd, Gd
Gd, Re, Gll^Fmf, Gll^Fdf, Hhd^Fmf, Hhd^Fmf, Gd, Gll^Fmf, Gll^Fmf, Md, Gd, Gd, Gd, Gd, Wwf, Wwf, Wwf, Wwg, Wwg, Wwg^Bw|r, Wwg, Ss, Ss, Ss, Khs, Chs, Chs, Wog, Wog, Wwg, Wog, Wwg, Gd, Ce, Rd, Re, Re, Rd, Rd, Gd, Re, Hhd^Fdf, Gll^Fmf, Hhd^Fdf, Gd, Gll^Fmf
Gd, Gll^Fmf, Gd, Gd, Gd, Gll^Fmf, Gd, Gd, Re, Gd, Re, Gd, Wwf, Wwg, Wwg, Wwg, Rb, Ss, Wog, Rb, Ss, Ss, Ss, Chs, Chs, Chs, Chs, Chs, Wog, Wwg, Wog, Wwg, Gll^Fmf, Gd^Es, Re^Vct, Rd, Rd, Rd, Ce, Rd, Re, Re^Vct, Gd, Gll^Fmf, Gd, Gd
Gd, Gll, Gll^Fmf, Gd, Gll^Fmf, Gd, Gll^Fmf, Gll^Fmf, Gd, Gd, Gd, Gd, Wwf, Wwg, Wwg, Ss, Ss, Sm, Wog, Rb, Ss, Ss, Rb, Ss, Ss, Ss, Ss, Chs, Rb, Wog, Wog, Wwg, Gd, Hhd^Fdf, Hhd^Fdf, Re, Gll^Fmf, Gll^Fmf, Re, Rd, Rd, Re, Gll^Fmf, Gll^Fmf, Gd, Gd
Re, Re, Gll^Fmf, Gd, Hhd, Gd, Gll^Fmf, Gll^Fmf, Gd, Gd, Gd, Wwf, Wwg, Wwg, Rb, Rb, Sm, Sm, Wog, Wwg, Ss, Sm, Sm, Ss, Sm, Rb, Ss, Ss, Rb, Sm, Ss, Wog, Gd, Hhd^Fdf, Gd, Gd, Gll^Fmf, Gd, Gd, Re, Re, Rd, Rd, Gd, Hhd, Hhd
Gd, Hhd^Fmf, Gd, Gll, Gd, Gll^Fmf, Hhd, Gd, Gd^Es, Gd, Wwf, Wwg^Bw\r, Ss, Sm, Ss, Ss, Ss, Wog, Ss, Ss, Rb, Ss, Ss, Sm, Ss, Sm, Rb, Rb, Ss, Rb, Ss, Wog, Gd, Gd, Gd, Re, Gll^Fmf, Gd, Gd, Re^Vct, Gd, Re, Rd, Re, Re, Gd
Gd, Gd, Gd^Vo, Gd, Hhd, Hhd, Hhd, Hhd, Gd, Gd, Wwf, Wwg, Ss, Sm, Sm, Sm, Wog, Wog, Wwg, Ss, Ss, Rb, Ss, Sm, Ss, Ss, Rb, Ss, Rb, Rb, Rb, Gd, Re, Gd, Gd, Gd, Gd, Gll^Fmf, Gll^Fmf, Gd, Gd, Re, Re, Re, Rd, Gd
Hhd, Gd, Gd, Gd, Hhd, Hhd, Hhd, Hhd, Gd, Hhd, Wwf, Wwg, Wog, Wog, Ss, Wog, Ss, Sm, Ss, Sm, Rb, Rb, Ss, Ss, Sm, Rb, Sm, Sm, Ss, Ss, Wwg, Rb, Ss, Gd^Es, Hhd^Fdf, Gd, Re, Re, Gd, Gd, Gd, Gd, Gd, Re, Rd, Re
Hhd, Hhd, Hhd, Gd, Hhd, Hhd, Hhd, Gd, Gd, Wwf, Wwg, Ss, Wog, Wwg, Ss, Ss, Sm, Sm, Ss, Ss, Sm, Sm, Sm, Sm, Rb, Rb, Ss, Ss, Sm, Ss, Wog, Wwg, Ss, Gd, Hhd^Fdf, Hhd^Fdf, Gd, Gd, Gd, Gd, Gd, Re, Gd, Re, Re, Re
Gd, Gd, Hhd, Hhd, Hhd, Gd, Gll^Fmf, Gd, Gd, Wwg, Wwg, Wog, Ss, Ss, Sm, Sm, Ss, Sm, Ss, Sm, Ss, Ss, Ss, Ss, Ss, Ss, Ss, Sm, Ss, Ss, Wog, Wwg, Ss, Gd, Hhd^Fdf, Hhd^Fdf, Hhd^Fdf, Re, Hhd^Fdf, Gd, Hhd^Fdf, Gd, Hhd^Fdf, Hhd^Fdf, Rd, Re
