border_size=1
usage=map

Xu, Xu, Xu, Xu, Xu, Xu, Xu, Xu, Xu, Xu, Xu, Xu, Xu, Xu, Xu, Xu, Xu, Xu, Xu, Xu, Xu, Xu, Xu, Xu, Xu, Xu, Xu, Xu, Xu, Xu, Xu, Xu, Xu, Xu, Uh, Xu, Wwg, Wwg, Wwf, Wwg, Wwg, Wwg, Xu, Xu, Xu, Xu, Xu, Xu, Xu, Xu, Xu, Xu, Xu, Xu, Xu, Xu, Xu, Xu, Xu, Xu, Xu, Xu, Xu, Xu, Xu, Xu
Xu, Xu, Xu, Xu, Xu, Xu, Xu, Xu, Xu, Xu, Xu, Xu, Xu, Xu, Xu, Xu, Xu, Xu, Xu, Xu, Xu, Xu, Xu, Xu, Xu, Xu, Xu, Xu, Xu, Xu, Xu, Xu, Xu, Uh, Uh, Xu, Xu, Ss, Wwg, Wwg, Wwf, Xu, Xu, Xu, Xu, Xu, Xu, Xu, Xu, Xu, Xu, Xu, Xu, Xu, Xu, Xu, Xu, Xu, Xu, Xu, Xu, Xu, Xu, Xu, Xu, Xu
Xu, Xu, Xu, Xu, Xu, Xu, Xu, Xu, Xu, Xu, Xu, Xu, Xu, Xu, Xu, Xu, Xu, Xu, Xu, Xu, Xu, Xu, Xu, Xu, Xu, Xu, Xu, Xu, Xu, Xu, Xu, Xu, Xu, Xu, Uh, Uh, Sm, Wwf, Ss, Wwg, Ss, Uh, Xu, Xu, Xu, Xu, Xu, Xu, Xu, Xu, Xu, Xu, Xu, Xu, Xu, Xu, Xu, Xu, Xu, Xu, Xu, Xu, Xu, Xu, Xu, Xu
Xu, Xu, Xu, Xu, Xu, Xu, Xu, Xu, Xu, Xu, Xu, Xu, Xu, Xu, Xu, Xu, Xu, Xu, Xu, Xu, Xu, Xu, Xu, Xu, Xu, Xu, Xu, Xu, Xu, Xu, Xu, Xu, Xu, Xu, Uh, Uh, Uh, Xu, Wwg, Wwg, Xu, Xu, Xu, Xu, Xu, Xu, Xu, Xu, Xu, Xu, Xu, Xu, Xu, Xu, Xu, Xu, Xu, Xu, Xu, Xu, Xu, Xu, Xu, Xu, Xu, Xu
Xu, Xu, Xu, Xu, Xu, Xu, Xu, Xu, Xu, Xu, Xu, Xu, Xu, Xu, Xu, Xu, Xu, Xu, Xu, Xu, Xu, Xu, Xu, Xu, Xu, Xu, Xu, Xu, Xu, Xu, Xu, Xu, Xu, Xu, Xu, Xu, Uh, Wwf, Wwg, Wwg, Wwg, Wwg, Xu, Xu, Xu, Xu, Xu, Xu, Xu, Xu, Xu, Xu, Xu, Xu, Xu, Xu, Xu, Xu, Xu, Xu, Xu, Xu, Xu, Xu, Xu, Xu
Xu, Xu, Xu, Xu, Xu, Xu, Xu, Xu, Xu, Xu, Xu, Xu, Xu, Xu, Xu, Xu, Xu, Xu, Xu, Xu, Xu, Xu, Xu, Xu, Xu, Xu, Xu, Xu, Xu, Xu, Xu, Xu, Xu, Xu, Xu, Uh, Uh, Xu, Wwg, Xu, Sm, Xu, Xu, Xu, Xu, Xu, Xu, Xu, Xu, Xu, Xu, Xu, Xu, Xu, Xu, Xu, Xu, Xu, Xu, Xu, Xu, Xu, Xu, Xu, Xu, Xu
Xu, Xu, Xu, Xu, Xu, Xu, Xu, Xu, Xu, Xu, Xu, Xu, Xu, Xu, Xu, Xu, Xu, Xu, Xu, Xu, Xu, Xu, Xu, Xu, Xu, Xu, Xu, Xu, Xu, Xu, Xu, Xu, Xu, Xu, Xu, Uh, Uh, Uh, Wwg, Wwf, Wwf, Wwg, Wwf, Xu, Xu, Xu, Xu, Xu, Xu, Xu, Xu, Xu, Xu, Xu, Xu, Xu, Xu, Xu, Xu, Xu, Xu, Xu, Xu, Xu, Xu, Xu
Xu, Xu, Xu, Xu, Xu, Xu, Xu, Xu, Xu, Xu, Xu, Xu, Xu, Xu, Xu, Xu, Xu, Xu, Xu, Xu, Xu, Xu, Xu, Xu, Xu, Xu, Xu, Xu, Xu, Xu, Xu, Xu, Xu, Xu, Xu, Xu, Uh, Uh, Xu, Wwg, Wwg, Wwg, Xu, Xu, Xu, Xu, Xu, Xu, Xu, Xu, Xu, Xu, Xu, Xu, Xu, Xu, Xu, Xu, Xu, Xu, Xu, Xu, Xu, Xu, Xu, Xu
Xu, Xu, Xu, Xu, Xu, Xu, Xu, Xu, Xu, Xu, Xu, Xu, Xu, Xu, Xu, Xu, Xu, Xu, Xu, Xu, Xu, Xu, Xu, Xu, Xu, Xu, Xu, Xu, Xu, Xu, Xu, Xu, Xu, Xu, Xu, Xu, Xu, Uh, Wwf, Ss, Wwg, Wwf, Wwg, Xu, Xu, Xu, Xu, Xu, Xu, Xu, Xu, Xu, Xu, Xu, Xu, Xu, Xu, Xu, Xu, Xu, Xu, Xu, Xu, Xu, Xu, Xu
Xu, Xu, Xu, Xu, Xu, Xu, Xu, Xu, Xu, Xu, Xu, Xu, Xu, Xu, Xu, Xu, Xu, Xu, Xu, Xu, Xu, Xu, Xu, Xu, Xu, Xu, Xu, Xu, Xu, Xu, Xu, Xu, Xu, Xu, Xu, Xu, Uh, Uh, Xu, Wwf, Wwf, Ss, Xu, Xu, Xu, Xu, Xu, Xu, Xu, Xu, Xu, Xu, Xu, Xu, Xu, Xu, Xu, Xu, Xu, Xu, Xu, Xu, Xu, Xu, Xu, Xu
Xu, Xu, Xu, Xu, Xu, Xu, Xu, Xu, Xu, Xu, Xu, Xu, Xu, Xu, Xu, Xu, Xu, Xu, Xu, Xu, Xu, Xu, Xu, Xu, Xu, Xu, Xu, Xu, Xu, Xu, Xu, Xu, Xu, Xu, Xu, Xu, Xu, Uh, Uh, Wwf, Wwf, Wwg, Wwf, Ss, Xu, Xu, Xu, Xu, Xu, Xu, Xu, Xu, Xu, Xu, Xu, Xu, Xu, Xu, Xu, Xu, Xu, Xu, Xu, Xu, Xu, Xu
Xu, Xu, Xu, Xu, Xu, Xu, Xu, Xu, Xu, Xu, Xu, Xu, Xu, Xu, Xu, Xu, Xu, Xu, Xu, Xu, Xu, Xu, Xu, Xu, Xu, Xu, Xu, Xu, Xu, Xu, Xu, Xu, Xu, Xu, Xu, Xu, Xu, Uh, Uh, Xu, Wwf, Wwg, Wwg, Xu, Xu, Xu, Xu, Xu, Xu, Xu, Xu, Xu, Xu, Xu, Xu, Xu, Xu, Xu, Xu, Xu, Xu, Xu, Xu, Xu, Xu, Xu
Xu, Xu, Xu, Xu, Xu, Xu, Xu, Xu, Xu, Xu, Xu, Xu, Xu, Xu, Xu, Xu, Xu, Xu, Xu, Xu, Xu, Xu, Xu, Xu, Xu, Xu, Xu, Xu, Xu, Xu, Xu, Xu, Xu, Xu, Xu, Xu, Xu, Uh, Uh, Wwg, Ss, Ss, Wwg, Uh, Ss, Uh, Uh, Xu, Xu, Xu, Xu, Xu, Xu, Xu, Xu, Xu, Xu, Xu, Xu, Xu, Xu, Xu, Xu, Xu, Xu, Xu
Xu, Xu, Xu, Xu, Xu, Xu, Xu, Xu, Xu, Xu, Xu, Xu, Xu, Xu, Xu, Xu, Xu, Xu, Xu, Xu, Xu, Xu, Xu, Xu, Xu, Xu, Xu, Xu, Xu, Xu, Xu, Xu, Xu, Xu, Xu, Xu, Xu, Uh, Uh, Wwf, Wwg, Wwg, Wwg, Wwf, Uh, Ss, Xu, Xu, Xu, Xu, Xu, Xu, Xu, Xu, Xu, Xu, Xu, Xu, Xu, Xu, Xu, Xu, Xu, Xu, Xu, Xu
Xu, Xu, Xu, Xu, Xu, Xu, Xu, Xu, Xu, Xu, Xu, Xu, Xu, Xu, Xu, Xu, Xu, Xu, Xu, Xu, Xu, Xu, Xu, Xu, Xu, Xu, Xu, Xu, Xu, Xu, Xu, Xu, Xu, Xu, Xu, Xu, Xu, Xu, Uh, Uu, Ss, Wwf, Wwf, Wwf, Uh, Ss, Xu, Uh^Dr, Uh, Xu, Uh, Xu, Xu, Xu, Xu, Xu, Xu, Xu, Xu, Xu, Xu, Xu, Xu, Xu, Xu, Xu
Xu, Xu, Xu, Xu, Xu, Xu, Xu, Xu, Xu, Xu, Xu, Xu, Xu, Xu, Xu, Xu, Xu, Xu, Xu, Xu, Xu, Xu, Xu, Xu, Xu, Xu, Xu, Xu, Xu, Xu, Xu, Xu, Xu, Xu, Xu, Xu, Xu, Xu, Uh, Uh, Xu, Wwg, Wwg, Wwg, Wwg, Uh, Xu, Xu, Xu, Uh, Uh, Xu, Xu, Xu, Xu, Xu, Uh, Uh, Qxu, Uu, Uu, Xu, Xu, Xu, Xu, Xu
Xu, Xu, Xu, Xu, Xu, Xu, Xu, Xu, Xu, Xu, Xu, Xu, Xu, Xu, Xu, Xu, Xu, Xu, Xu, Xu, Xu, Xu, Xu, Xu, Xu, Xu, Xu, Xu, Xu, Xu, Xu, Xu, Xu, Xu, Xu, Xu, Xu, Xu, Xu, Uh, Uh, Wwg, Wwg, Wwf, Wwg, Uh, Xu, Xu, Xu, Xu, Uh, Uu, Uu, Uh, Uu, Uh, Qxu, Qxu, Urb, Qxu, Qxu, Uh, Uu, Xu, Xu, Xu
Xu, Xu, Xu, Xu, Xu, Xu, Xu, Xu, Xu, Xu, Xu, Xu, Xu, Xu, Xu, Xu, Xu, Xu, Xu, Xu, Xu, Xu, Xu, Xu, Xu, Xu, Xu, Xu, Xu, Xu, Xu, Xu, Xu, Xu, Xu, Xu, Xu, Xu, Xu, Uh, Wwg, Wwg, Wwg, Wwf, Ss, Xu, Xu, Xu, Xu, Xu, Xu, Uh, Uh, Uh, Uu, Uu, Qxu, Urb, Urb, Urb, Qxu, Uu, Uu, Xu, Xu, Xu
Xu, Xu, Xu, Xu, Xu, Xu, Xu, Xu, Xu, Xu, Xu, Xu, Xu, Xu, Xu, Xu, Xu, Xu, Xu, Xu, Xu, Xu, Xu, Xu, Xu, Xu, Xu, Xu, Xu, Xu, Xu, Xu, Xu, Xu, Xu, Xu, Xu, Xu, Uh, Uh, Wwf, Wwg, Wwg, Wwg, Uh, Xu, Xu, Xu, Xu, Xu, Xu, Xu, Uh, Uu, Ur, Qxu, Qxu, Urb, Urb, Urb, Qxu, Qxu, Ur, Uh, Xu, Xu
Xu, Xu, Xu, Xu, Xu, Xu, Xu, Xu, Xu, Xu, Xu, Xu, Xu, Xu, Xu, Xu, Xu, Xu, Xu, Xu, Xu, Xu, Xu, Xu, Xu, Xu, Xu, Xu, Xu, Xu, Xu, Xu, Xu, Xu, Xu, Xu, Uh, Uh, Uh, Cud, Wwf, Wwg, Wwg, Cud, Uh, Xu, Xu, Xu, Xu, Xu, Xu, Uh, Uu, Uu, Ur, Qxu, Qxu, Qxu, Ur, Qxu, Qxu, Qxu, Ur, Uu, Xu, Xu
Xu, Xu, Xu, Xu, Xu, Xu, Xu, Xu, Xu, Xu, Xu, Xu, Xu, Xu, Xu, Xu, Xu, Xu, Xu, Xu, Xu, Xu, Xu, Xu, Xu, Xu, Xu, Xu, Xu, Xu, Xu, Xu, Xu, Xu, Xu, Xu, Uh, Uh, Xu, Uh, Wwg, Xu, Wwf, Uh, Uh, Ss, Xu, Xu, Xu, Xu, Xu, Xu, Uh, Uh, Uu, Uu, Uu, Ur, Ur, Ur, Uu, Uu, Uh, Uh, Xu, Xu
Xu, Xu, Xu, Xu, Xu, Xu, Xu, Xu, Xu, Xu, Xu, Xu, Xu, Xu, Xu, Xu, Xu, Xu, Xu, Xu, Xu, Xu, Xu, Xu, Xu, Xu, Xu, Xu, Xu, Xu, Xu, Xu, Xu, Xu, Xu, Uh, Xu, Uh, Xu, Wwf, Ss, Wwg, Xu, Wwg, Uh, Ss, Xu, Xu, Xu, Xu, Xu, Xu, Xu, Xu, Xu, Uh, Uh, Uu, Ur, Uu, Uh, Uu, Uh, Xu, Xu, Xu
Xu, Xu, Xu, Xu, Xu, Xu, Xu, Xu, Xu, Xu, Xu, Xu, Xu, Xu, Xu, Xu, Xu, Xu, Xu, Xu, Xu, Xu, Xu, Xu, Xu, Xu, Xu, Xu, Xu, Xu, Uh, Uh, Uh, Uh, Uu, Uh, Uh, Uu, Wwg, Wwf, Wwg, Ss, Wwg, Sm, Ss, Ss, Xu, Xu, Xu, Xu, Xu, Xu, Xu, Xu, Xu, Uh, Xu, Uu, Uh, Uh, Xu, Uh, Xu, Xu, Xu, Xu
Xu, Xu, Xu, Xu, Xu, Xu, Xu, Xu, Xu, Xu, Xu, Xu, Xu, Xu, Xu, Xu, Xu, Xu, Xu, Xu, Xu, Xu, Xu, Xu, Uh, Xu, Uh, Uh, Uh, Uh, Uu, Uh, Uu, Uu, Uu, Uu, Uh, Uu, Wwf, Wwf, Wwg, Ss, Xu, Xu, Ss, Uh, Xu, Xu, Xu, Xu, Xu, Xu, Xu, Xu, Xu, Xu, Xu, Xu, Uh, Xu, Xu, Xu, Xu, Xu, Xu, Xu
Xu, Xu, Xu, Xu, Xu, Xu, Xu, Xu, Xu, Xu, Xu, Xu, Xu, Xu, Xu, Xu, Xu, Xu, Xu, Xu, Uh, Xu, Uh, Uh, Uh, Uh, Uh, Uu, Uh, Xu, Uh, Uu, Uu, Xu, Ur, Uh, Wwf, Xu, Wwg, Wwg, Wwg, Wwg, Ss, Xu, Uh, Sm, Uh, Xu, Xu, Xu, Xu, Xu, Xu, Xu, Xu, Xu, Xu, Xu, Xu, Uh, Xu, Xu, Xu, Xu, Xu, Xu
Xu, Xu, Xu, Xu, Xu, Xu, Xu, Xu, Xu, Xu, Xu, Xu, Xu, Xu, Xu, Xu, Xu, Xu, Xu, Xu, Uh, Uh, Uu, Uh, Uu, Uh, Uu, Uh, Uu, Ur, Ur, Uh, Uu, Uu, Uu, Xu, Wwg, Wwg, Wwg, Ss, Wwg, Ss, Xu, Xu, Xu, Ss, Wwf, Xu, Xu, Xu, Xu, Xu, Xu, Xu, Xu, Xu, Xu, Xu, Xu, Uh, Xu, Xu, Xu, Xu, Xu, Xu
Xu, Xu, Xu, Xu, Xu, Xu, Xu, Xu, Xu, Xu, Xu, Xu, Xu, Xu, Xu, Xu, Xu, Xu, Uh, Uh, Xu, Uu, Uu, Xu, Uu, Ur, Uu, Uh, Uu, Uu, Ur, Xu, Uu, Ur, Uu, Xu, Wwg, Wwg, Wwg, Wwg, Wwg, Xu, Xu, Xu, Xu, Uh, Wwf, Xu, Xu, Xu, Xu, Xu, Xu, Xu, Xu, Xu, Xu, Xu, Xu, Uh, Xu, Xu, Xu, Xu, Xu, Xu
Xu, Xu, Xu, Xu, Xu, Xu, Xu, Xu, Xu, Xu, Xu, Xu, Xu, Xu, Xu, Xu, Xu, Uh, Xu, Uh, Uu, Uh, Uu, Uh, Ur, Ur, Ur, Ur, Uh, Ur, Uh, Uu, Ur, Uu, Xu, Wwf, Wwg, Wwg, Wwg, Wwf, Wwf, Xu, Xu, Xu, Xu, Xu, Wwf, Wwg, Wwf, Xu, Xu, Xu, Xu, Xu, Xu, Xu, Xu, Xu, Xu, Uh, Xu, Xu, Xu, Xu, Xu, Xu
Xu, Xu, Xu, Xu, Xu, Xu, Xu, Xu, Xu, Xu, Xu, Xu, Xu, Xu, Xu, Xu, Uh, Uh, Xu, Ur, Uh, Uu, Uu, Ur, Uh, Uu, Ur, Ur, Uh, Uu, Uu, Ur, Uu, Uh, Xu, Xu, Wwf, Xu, Wwf, Xu, Xu, Xu, Xu, Xu, Xu, Xu, Wwf, Wwf, Wwf, Xu, Xu, Xu, Xu, Xu, Xu, Xu, Xu, Xu, Uh, Uh, Xu, Xu, Xu, Xu, Xu, Xu
Xu, Xu, Xu, Xu, Xu, Xu, Xu, Xu, Xu, Xu, Xu, Xu, Xu, Xu, Uh, Xu, Xu, Ur, Ur, Ur, Ur, Uu, Ur, Ur, Ur, Ur, Uu, Uu, Uu, Uu, Uu, Ur, Ur, Uh, Xu, Wwg, Xu, Wwg, Xu, Ss, Xu, Xu, Xu, Xu, Xu, Xu, Xu, Wwg, Xu, Wwf, Wwf, Xu, Xu, Xu, Xu, Xu, Xu, Xu, Uh, Uh, Xu, Xu, Xu, Xu, Xu, Xu
Xu, Xu, Xu, Xu, Xu, Xu, Xu, Xu, Xu, Xu, Xu, Xu, Xu, Xu, Uh, Uh, Uh, Uu, Ur, Uh, Uu, Uh, Ur, Ur, Ur, Uu, Uu, Uu, Uh, Uu, Xu, Ur, Xu, Wwg, Wwf, Ss, Wwf, Wwf, Xu, Xu, Xu, Xu, Xu, Xu, Xu, Xu, Xu, Wwg, Xu, Wwf, Wwf, Wwg, Xu, Xu, Xu, Xu, Xu, Xu, Uu, Xu, Xu, Xu, Xu, Xu, Xu, Xu
Xu, Xu, Xu, Xu, Xu, Xu, Xu, Xu, Xu, Xu, Xu, Xu, Uh, Uh, Ur, Xu, Ur, Ur, Uu, Ur, Ur, Ur, Xu, Ur, Xu, Ur, Uu, Ur, Uu, Ur, Xu, Xu, Xu, Wwg, Wwg, Xu, Wwg, Xu, Xu, Xu, Xu, Xu, Xu, Xu, Xu, Xu, Xu, Uh, Xu, Xu, Wwf, Wwf, Wwg, Xu, Xu, Xu, Xu, Xu, Uh, Xu, Xu, Xu, Xu, Xu, Xu, Xu
Xu, Xu, Xu, Xu, Xu, Xu, Xu, Xu, Xu, Xu, Xu, Xu, Uh, Uh, Uu, Ur, Ur, Uu, Uu, Ur, Xu, Xu, Cud, Xu, Ur, Uu, Ur, Uh, Uh, Uu, Xu, Wwg, Wwf, Wwg, Wwf, Wwf, Xu, Wwf, Xu, Xu, Xu, Xu, Uh, Uh, Xu, Xu, Xu, Xu, Xu, Xu, Wwg, Wwf, Ss, Xu, Xu, Xu, Xu, Uh, Xu, Xu, Xu, Xu, Xu, Xu, Xu, Xu
Xu, Xu, Xu, Xu, Xu, Xu, Xu, Xu, Xu, Xu, Xu, Uh, Uh, Xu, Ur, Ur, Uh, Uu, Xu, Xu, Cud, Cud, Cud, Cud, Ur, Ur, Uu, Uu, Uh, Xu, Ss, Wwg, Wwf, Xu, Ss, Ss, Xu, Xu, Xu, Xu, Uh, Uh, Uu, Qxu, Qxu, Xu, Xu, Uh, Xu, Xu, Xu, Wwf, Wwf, Uu, Uh, Xu, Xu, Uh, Xu, Xu, Xu, Xu, Xu, Xu, Xu, Xu
Xu, Xu, Xu, Xu, Xu, Xu, Xu, Xu, Xu, Xu, Uh, Xu, Uu, Uu, Ur, Ur, Uu, Uu, Xu, Cud, Cud, 3 Kud, Cud, Cud, Uu, Uu, Uu, Uu, Ss, Wwf, Wwf, Wwg, Wwg, Wwf, Xu, Wwf, Xu, Xu, Xu, Xu, Uh, Uu, Qxu, Qxu, Qxu, Uh, Wwg, Ss, Xu, Xu, Uu, Wwf, Wwf, Ur, Ur, Xu, Uh^Dr, Uu, Xu, Xu, Xu, Xu, Xu, Xu, Xu, Xu
Xu, Xu, Xu, Xu, Xu, Xu, Xu, Xu, Xu, Xu, Uh, Uh, Uu, Uu, Ur, Uu, Ur, Ur, Uu, Cud, Cud, Cud, Ur, Uu, Uh, Uh, Uh, Uu, Xu, Wwg, Wwf, Wwg, Ss, Wwg, Xu, Xu, Xu, Xu, Xu, Xu, Xu, Uu, Qxu, Qxu, Uh, Uh, Wwf, Ss, Ss, Xu, Wwf, Wwf, Wwg, Ss, Xu, Uh, Xu, Xu, Xu, Xu, Xu, Xu, Xu, Xu, Xu, Xu
Xu, Xu, Xu, Xu, Xu, Xu, Xu, Xu, Xu, Xu, Uh, Uh, Uu, Ur, Uu, Ur, Xu, Uu, Uu, Ur, Uu, Ur, Uu, Uu, Ur, Uu, Uh, Uu, Ss, Wwg, Wwg, Wwg, Wwg, Wwf, Xu, Xu, Xu, Xu, Xu, Xu, Xu, Qxu, Xu, Uh, Uh, Wwf, Ss, Ss, Ss, Wwf, Ss, Wwf, Xu, Xu, Xu, Uu, Ur, Xu, Xu, Xu, Uh, Xu, Xu, Xu, Xu, Xu
Xu, Xu, Xu, Xu, Xu, Xu, Xu, Xu, Xu, Xu, Ur, Uu, Ur, Ur, Ur, Uh, Ur, Ur, Ur, Uu, Uu, Ur, Ur, Ur, Uu, Uu, Wwg, Wwf, Wwf, Ss, Wwg, Wwg, Xu, Xu, Xu, Xu, Xu, Xu, Xu, Xu, Xu, Xu, Xu, Xu, Wwf, Wwf, Wwf, Ss, Xu, Ss, Uh, Xu, Xu, Xu, Xu, Xu, Uu, Ur, Xu, Xu, Uh, Uh, Xu, Xu, Xu, Xu
Xu, Xu, Xu, Xu, Xu, Xu, Xu, Xu, Xu, Uh, Uu, Ur, Uh, Ur, Ur, Ur, Ur, Uu, Ur, Uu, Uh, Ur, Uu, Uu, Wwg, Uu, Wwg, Wwf, Wwg, Ss, Wwg, Wwf, Ss, Xu, Xu, Xu, Xu, Xu, Xu, Xu, Xu, Xu, Xu, Xu, Wwf, Wwf, Xu, Ss, Ss, Ss, Ur, Xu, Xu, Xu, Xu, Xu, Xu, Ur, Ur, Uh, Uu, Uh, Uh, Xu, Xu, Xu
Xu, Xu, Xu, Xu, Xu, Xu, Xu, Xu, Uh, Uu, Ur, Uu, Uu, Uu, Xu, Ur, Ur, Ur, Uu, Uu, Uu, Ur, Wwf, Xu, Sm, Wwf, Wwf, Wwf, Wwg, Wwf, Wwf, Wwf, Xu, Xu, Xu, Xu, Xu, Xu, Xu, Xu, Xu, Xu, Xu, Wwf, Wwf, Ss, Ss, Ss, Xu, Uh, Uu, Uu, Uu, Xu, Xu, Xu, Uh, Uh, Uu, Ur, Ur, Uu, Uh, Uh, Xu, Xu
Xu, Xu, Xu, Xu, Xu, Xu, Xu, Xu, Uu, Uu, Uu, Uu, Uh, Uu, Ur, Uu, Ur, Ur, Uh, Uu, Ur, Xu, Wwf, Ss, Wwg, Ss, Wwg, Ss, Wwg, Wwg, Xu, Wwf, Xu, Xu, Xu, Xu, Xu, Xu, Xu, Xu, Ss, Xu, Wwf, Wwf, Ss, Ss, Wwg, Xu, Xu, Xu, Uh, Ur, Ur, Xu, Xu, Xu, Uh, Uu, Ur, Ur, Ur, Uu, Uu, Uh, Xu, Xu
Xu, Xu, Xu, Xu, Xu, Xu, Xu, Uh, Uu, Ur, Uu, Uh, Uh, Uh, Uu, Uh, Ur, Ur, Ur, Ur, Wwg, Wwf, Wwg, Wwf, Wwg, Sm, Wwg, Wwg, Xu, Xu, Xu, Wwf, Xu, Xu, Xu, Xu, Xu, Xu, Xu, Ss, Ss, Wwf, Wwf, Ss, Ss, Wwg, Xu, Xu, Xu, Xu, Xu, Uh, Uu, Ur, Ur, Uu, Ur, Uu, Ur, Ur, Ur, Ur, Uu, Uh, Xu, Xu
Xu, Xu, Xu, Xu, Xu, Xu, Xu, Uh, Uh, Xu, Uu, Xu, Xu, Uu, Uh, Ur, Ur, Ur, Ur, Wwf, Wwg, Wwg, Wwg, Wwg, Wwg, Xu, Xu, Xu, Xu, Xu, Xu, Ss, Wwf, Xu, Xu, Xu, Xu, Xu, Wwg, Ss, Wwf, Wwf, Ss, Ss, Ss, Wwf, Xu, Xu, Xu, Xu, Xu, Xu, Xu, Uu, Xu, Ur, Uu, Ur, Ur, Ur, Ur, Ur, Uu, Uh, Uh, Xu
Xu, Xu, Xu, Xu, Xu, Xu, Xu, Xu, Xu, Uu, Ur, Ur, Ur, Ur, Uu, Uu, Ur, Uh, Uh, Wwf, Wwg, Wwg, Wwg, Ss, Wwf, Xu, Xu, Xu, Xu, Xu, Xu, Uh, Wwg, Xu, Xu, Xu, Wwf, Wwf, Xu, Wwf, Xu, Ss, Ss, Ss, Xu, Ss, Uh, Xu, Xu, Xu, Uh, Xu, Xu, Xu, Xu, Uh, Uh, Uu, Uu, Ur, Ur, Ur, Uu, Uh, Uh, Xu
Xu, Xu, Xu, Xu, Xu, Xu, Xu, Xu, Uh, Ur, Uh, Uu, Uu, Uu, Ur, Uu, Xu, Ur, Sm, Wwg, Wwg, Wwf, Wwf, Wwg, Xu, Xu, Xu, Xu, Xu, Xu, Xu, Xu, Uh, Xu, Xu, Xu, Wwf, Xu, Xu, Xu, Xu, Xu, Xu, Xu, Wwg, Wwf, Xu, Uh, Xu, Uh, Uu, Uh, Uh, Xu, Xu, Xu, Uh, Uu, Ur, Ur, Ur, Uu, Uu, Uu, Xu, Xu
Xu, Xu, Xu, Xu, Xu, Xu, Xu, Uh, Uu, Uu, Uh, Ur, Ur, Ur, Ur, Ur, Wwg, Xu, Wwg, Wwf, Wwg, Sm, Wwg, Wwf, Xu, Xu, Xu, Xu, Xu, Xu, Xu, Xu, Xu, Uh, Wwf, Ss, Xu, Xu, Xu, Xu, Xu, Xu, Xu, Xu, Wog, Xu, Xu, Uh, Qxu, Qxu, Qxu, Uu, Xu, Xu, Xu, Xu, Xu, Uh, Ur, Ur, Uu, Uu, Uh, Uh, Xu, Xu
Xu, Xu, Xu, Xu, Xu, Xu, Xu, Uh, Uh, Uu, Uu, Uu, Ur, Ur, Uu, Xu, Wwf, Ss, Wwg, Wwg, Wwf, Wwg, Wwg, Wwg, Xu, Xu, Xu, Xu, Xu, Xu, Xu, Xu, Xu, Xu, Wwf, Xu, Xu, Xu, Xu, Xu, Xu, Xu, Xu, Xu, Wwg, Xu, Xu, Uu, Uh, Qxu, Uh, Xu, Xu, Xu, Xu, Xu, Xu, Xu, Ur, Uh, Uu, Uh, Qxu, Qxu, Uh, Xu
Xu, Xu, Xu, Xu, Xu, Xu, Xu, Xu, Uh, Uh, Uh, Ur, Uu, Ur, Ur, Xu, Wwg, Wwf, Wwg, Wwf, Ss, Wwg, Wwf, Xu, Xu, Xu, Xu, Xu, Xu, Xu, Xu, Xu, Xu, Ss, Ss, Wwf, Xu, Xu, Xu, Xu, Xu, Xu, Xu, Wwf, Xu, Xu, Xu, Xu, Xu, Uh, Xu, Xu, Xu, Xu, Xu, Xu, Xu, Xu, Ur, Xu, Xu, Xu, Qxu, Qxu, Uh, Xu
Xu, Xu, Xu, Xu, Xu, Xu, Xu, Xu, Xu, Uu, Xu, Xu, Ur, Uh, Ur, Xu, Wwg, Wwg, Ss, Ss, Wwf, Wwg, Xu, Xu, Xu, Xu, Xu, Xu, Xu, Xu, Xu, Xu, Wwf, Wwf, Xu, Wwf, Wwf, Xu, Xu, Xu, Xu, Xu, Xu, Ss, Xu, Xu, Xu, Xu, Xu, Uh, Uh, Xu, Xu, Xu, Xu, Xu, Xu, Uh, Uu, Xu, Xu, Xu, Uu, Uu, Xu, Xu
Xu, Xu, Xu, Xu, Xu, Xu, Xu, Xu, Xu, Xu, Xu, Xu, Uu, Ur, Uu, Xu, Xu, Wwg, Wwg, Wwf, Wwf, Wwf, Wwg, Xu, Xu, Xu, Xu, Xu, Xu, Xu, Ss, Wwf, Xu, Xu, Xu, Xu, Wwf, Xu, Xu, Xu, Xu, Xu, Xu, Wwg, Xu, Xu, Xu, Xu, Xu, Xu, Uh, Xu, Xu, Xu, Xu, Xu, Ur, Ur, Xu, Xu, Xu, Uh, Uh, Uh, Xu, Xu
Xu, Xu, Xu, Xu, Xu, Xu, Xu, Xu, Xu, Xu, Xu, Xu, Xu, Ur, Uu, Xu, Wwf, Ss, Wwf, Wwg, Wwf, Wwg, Wwg, Xu, Xu, Xu, Xu, Xu, Xu, Xu, Wwf, Xu, Xu, Xu, Xu, Xu, Xu, Wwg, Ss, Xu, Xu, Xu, Wwg, Ss, Xu, Xu, Xu, Xu, Xu, Xu, Uh, Xu, Xu, Xu, Ur, Ur, Xu, Uh, Xu, Xu, Xu, Xu, Xu, Xu, Xu, Xu
Xu, Xu, Xu, Xu, Xu, Xu, Xu, Xu, Uh, Xu, Ur, Ur, Uu, Uh, Uh, Xu, Xu, Xu, Wwg, Ss, Wwf, Wwg, Ss, Xu, Wwg, Xu, Xu, Xu, Wwg, Wwf, Xu, Xu, Xu, Xu, Xu, Xu, Xu, Ss, Wwf, Xu, Xu, Xu, Wog, Xu, Xu, Xu, Xu, Xu, Xu, Xu, Uh, Xu, Uu, Xu, Ur, Uh, Xu, Xu, Xu, Xu, Xu, Xu, Xu, Xu, Xu, Xu
Xu, Xu, Xu, Xu, Xu, Xu, Uh, Uu, Uu, Ur, Ur, Uu, Uh, Uu, Uu, Uu, Xu, Wwg, Wwg, Wwf, Wwf, Wwg, Wwg, Wwg, Xu, Xu, Xu, Xu, Ss, Xu, Xu, Xu, Xu, Xu, Xu, Xu, Xu, Uh, Xu, Wwf, Xu, Wwg, Xu, Xu, Xu, Xu, Xu, Xu, Xu, Xu, Uh, Uu, Ur, Ur, Uh, Xu, Xu, Xu, Xu, Xu, Xu, Xu, Xu, Xu, Xu, Xu
Xu, Xu, Xu, Xu, Xu, Xu, Uh, Uu, Uu, Ur, Uu, Uh, Uu, Ur, Ur, Ur, Xu, Xu, Xu, Wwf, Wwf, Wwg, Wwf, Wwf, Wwg, Xu, Xu, Wwf, Xu, Xu, Xu, Xu, Xu, Xu, Xu, Uh, Uu, 4 Uh, Xu, Wwf, Wwf, Wwf, Xu, Xu, Xu, Xu, Xu, Xu, Uh, Uh, Ur, Ur, Ur, Uu, Xu, Xu, Xu, Xu, Xu, Xu, Xu, Xu, Xu, Xu, Xu, Xu
Xu, Xu, Xu, Xu, Uh, Uh, Ur, Uu, Uh, Ur, Uu, Uu, Uu, Uh, Ur, Uu, Uh, Ur, Wwf, Wwg, Wwg, Wwg, Wwg, Wwg, Wwg, Wwf, Wwg, Wwf, Xu, Xu, Xu, Xu, Xu, Xu, Uu, Uu, Xu, Xu, Xu, Xu, Wwf, Wwg, Xu, Xu, Xu, Xu, Xu, Xu, Uh, Uu, Ur, Ur, Ur, Uh, Xu, Xu, Xu, Xu, Xu, Xu, Xu, Xu, Xu, Xu, Xu, Xu
Xu, Xu, Xu, Xu, Uh, Uu, Uu, Uu, Cud, Cud, Cud, Ur, Uu, Ur, Ur, Ur, Ur, Uh, Ur, Xu, Wwg, Wwf, Wwg, Wwg, Wwg, Ss, Wwg, Xu, Xu, Xu, Xu, Xu, Xu, Xu, Uu, Xu, Xu, Xu, Wog, Wwg, Xu, Xu, Xu, Xu, Xu, Xu, Xu, Xu, Uh, Ur, Ur, Ur, Ur, Uh, Xu, Xu, Xu, Xu, Xu, Xu, Xu, Xu, Xu, Xu, Xu, Xu
Xu, Xu, Xu, Xu, Xu, Uu, Ur, Uu, Cud, Cud, Cud, Uu, Ur, Ur, Uh, Uu, Uu, Ur, Uu, Xu, Wwg, Wwg, Wwg, Ss, Wwg, Wwg, Ss, Xu, Wwf, Xu, Xu, Xu, Xu, Uh, Uu, Xu, Xu, Xu, Wwg, Xu, Xu, Xu, Xu, Xu, Xu, Xu, Xu, Uh, Xu, Uu, Uh, Uh, Uh, Ur, Uu, Xu, Xu, Xu, Xu, Xu, Xu, Xu, Xu, Xu, Xu, Xu
Xu, Xu, Xu, Xu, Xu, Xu, Ur, Ur, Cud, 2 Kud, Cud, Uu, Ur, Ur, Uu, Ur, Uu, Uu, Ur, Xu, Ss, Wwg, Wwf, Wwg, Wwg, Wwg, Wwg, Ss, Wwf, Xu, Xu, Xu, Uu, Uu, Uu, Xu, Xu, Wwg, Wwf, Xu, Xu, Xu, Xu, Xu, Xu, Xu, Xu, Uh, Xu, Xu, Xu, Xu, Uh, Ur, Ur, Xu, Xu, Xu, Xu, Xu, Xu, Xu, Xu, Xu, Xu, Xu
Xu, Xu, Xu, Xu, Xu, Uu, Uh, Uu, Cud, Cud, Cud, Uu, Ur, Ur, Ur, Uu, Uh, Xu, Ur, Ur, Ur, Ss, Wwg, Wwg, Wwg, Wwg, Wwg, Wwf, Wwg, Xu, Uh, Uu, Xu, Xu, Uh, Uh, Wwf, Wwf, Uu, Uu, Uu, Uh, Xu, Xu, Xu, Uh, Xu, Xu, Xu, Xu, Xu, Xu, Xu, Uu, Ur, Ur, Uh, Xu, Xu, Xu, Xu, Xu, Xu, Xu, Xu, Xu
Xu, Xu, Xu, Xu, Xu, Uh, Uh, Uu, Uu, Cud, Ur, Ur, Uu, Uh, Ur, Ur, Uu, Uu, Xu, Ur, Uu, Wwg, Xu, Wwg, Wwg, Wwg, Wwg, Wwg, Ss, Wwg, Wwf, Xu, Xu, Xu, Xu, Xu, Wwg, Xu, Xu, Uh, Ur, Uh, Uh, Xu, Uh, Uh, Xu, Xu, Xu, Xu, Xu, Xu, Xu, Xu, Uh, Ur, Ur, Xu, Xu, Xu, Uh, Xu, Xu, Xu, Xu, Xu
Xu, Xu, Xu, Xu, Xu, Uh, Uu, Uu, Uu, Uu, Ur, Uu, Ur, Uu, Uu, Ur, Uu, Ur, Uu, Xu, Xu, Ur, Xu, Ss, Wwf, Ss, Wwg, Wwg, Wwg, Wwg, Wwf, Xu, Xu, Xu, Xu, Wwg, Xu, Xu, Xu, Xu, Xu, Ur, Ur, Uh, Xu, Xu, Xu, Xu, Xu, Xu, Xu, Xu, Xu, Xu, Xu, Uh, Ur, Uu, Uh, Uh, Uh, Xu, Xu, Xu, Xu, Xu
Xu, Xu, Xu, Xu, Xu, Uh, Uh, Uu, Uu, Uu, Uu, Ur, Uu, Ur, Uu, Ur, Uu, Uh, Uu, Xu, Xu, Uh, Ur, Wwg, Wwg, Ss, Ss, Wwg, Wwf, Wwf, Uu, Uh, Xu, Xu, Wwg, Wwg, Xu, Xu, Xu, Xu, Xu, Uh, Uu, Ur, Ur, Xu, Uu, Xu, Xu, Xu, Xu, Xu, Xu, Xu, Xu, Xu, Uu, Ur, Uu, Uh, Uh, Xu, Xu, Xu, Xu, Xu
Xu, Xu, Xu, Xu, Xu, Xu, Xu, Uu, Uu, Uu, Ur, Uu, Uu, Uh, Uh, Uu, Uu, Uh, Uh, Xu, Xu, Xu, Ur, Wwf, Xu, Wwg, Wwf, Wwf, Wwg, Wwg, Uu, Xu, Xu, Wwf, Wwf, Xu, Xu, Xu, Xu, Xu, Xu, Xu, Xu, Uu, Uu, Ur, Ur, Uh, Xu, Xu, Xu, Xu, Xu, Xu, Uu, Uh, Ur, Ur, Ur, Uu, Uh, Uh, Xu, Xu, Xu, Xu
Xu, Xu, Xu, Xu, Xu, Xu, Xu, Uh, Uh, Uu, Uu, Uh, Uu, Uu, Uh, Uu, Uh, Uh, Uu, Xu, Xu, Xu, Xu, Uh, Xu, Wwf, Wwf, Wwf, Wwf, Wwg, Wwg, Xu, Wwf, Wwf, Ss, Xu, Xu, Xu, Xu, Xu, Xu, Xu, Xu, Xu, Xu, Uh, Xu, Ur, Ur, Xu, Xu, Xu, Xu, Uh, Uu, Uu, Ur, Ur, Ur, Uu, Uu, Uh, Xu, Xu, Xu, Xu
Xu, Xu, Xu, Xu, Xu, Xu, Xu, Xu, Xu, Uh, Uh, Uh, Xu, Uh, Xu, Xu, Xu, Xu, Xu, Uh, Xu, Xu, Xu, Xu, Wwf, Xu, Wwf, Wwf, Wwg, Wwg, Wwg, Wwf, Wwg, Wwg, Xu, Xu, Xu, Xu, Xu, Xu, Xu, Xu, Xu, Xu, Xu, Xu, Xu, Uh, Uu, Ur, Ur, Ur, Ur, Xu, Ur, Ur, Ur, Ur, Uu, Uu, Uh, Uh, Xu, Xu, Xu, Xu
Xu, Xu, Xu, Xu, Xu, Xu, Xu, Xu, Xu, Xu, Xu, Xu, Xu, Xu, Xu, Xu, Xu, Xu, Xu, Uh, Uu, Xu, Xu, Xu, Wwf, Wwf, Wwf, Wwf, Ss, Wwg, Wwg, Wwf, Wwg, Wwf, Wwf, Xu, Xu, Xu, Xu, Xu, Xu, Xu, Xu, Xu, Xu, Xu, Qxu, Qxu, Qxu, Uh, Xu, Xu, Xu, Ur, Uu, Ur, Uu, Ur, Uu, Uu, Uh, Xu, Xu, Xu, Xu, Xu
Xu, Xu, Xu, Xu, Xu, Xu, Xu, Xu, Xu, Xu, Xu, Xu, Xu, Xu, Xu, Xu, Xu, Xu, Xu, Uh, Uh, Xu, Xu, Wwf, Ur, Wwf, Xu, Ss, Wwf, Wwg, Ss, Wwg, Wwf, Xu, Xu, Xu, Xu, Xu, Xu, Xu, Xu, Xu, Xu, Xu, Xu, Xu, Uu, Qxu, Qxu, Qxu, Xu, Xu, Xu, Uh, Uh, Uh, Uh, Uu, Uh, Uh, Xu, Xu, Xu, Xu, Xu, Xu
Xu, Xu, Xu, Xu, Xu, Xu, Xu, Xu, Xu, Xu, Xu, Xu, Xu, Xu, Xu, Xu, Xu, Xu, Xu, Xu, Xu, Uh, Uu, Wwf, Xu, Xu, Xu, Wwg, Wwg, Wwg, Wwg, Wwf, Wwg, Wwg, Ss, Xu, Wwg, Xu, Wwg, Xu, Xu, Xu, Xu, Xu, Xu, Xu, Uh, Uu, Uu, Qxu, Xu, Xu, Xu, Xu, Xu, Uh, Xu, Uu, Xu, Uh, Xu, Xu, Xu, Xu, Xu, Xu
Xu, Xu, Xu, Xu, Xu, Xu, Xu, Xu, Xu, Xu, Xu, Xu, Xu, Xu, Xu, Xu, Xu, Xu, Xu, Xu, Xu, Ur, Uu, Wwf, Xu, Xu, Xu, Wwf, Wwf, Wwg, Wwg, Wwf, Wwg, Wwg, Wwf, Wwf, Wwg, Wwf, Wwf, Xu, Wwg, Xu, Xu, Xu, Xu, Xu, Xu, Uh, Uh, Uh, Xu, Xu, Xu, Xu, Xu, Xu, Xu, Xu, Xu, Uh, Uh, Xu, Xu, Xu, Xu, Xu
Xu, Xu, Xu, Xu, Xu, Xu, Xu, Xu, Xu, Xu, Xu, Xu, Xu, Xu, Xu, Xu, Xu, Xu, Xu, Xu, Ur, Ur, Uu, Xu, Xu, Xu, Xu, Xu, Wwg, Wwg, Wwg, Wwf, Wwf, Wwf, Wwf, Wwg, Ss, Sm, Wwf, Sm, Wwf, Xu, Xu, Xu, Xu, Xu, Xu, Xu, Xu, Xu, Xu, Xu, Xu, Xu, Xu, Xu, Xu, Xu, Uu, Uu, Uu, Xu, Xu, Xu, Xu, Xu
Xu, Xu, Xu, Xu, Xu, Xu, Xu, Xu, Xu, Xu, Xu, Xu, Xu, Xu, Xu, Xu, Xu, Xu, Xu, Xu, Ur, Uu, Xu, Xu, Xu, Xu, Xu, Xu, Xu, Wwf, Ss, Wwg, Wwg, Wwg, Wwg, Wwg, Ss, Ss, Wwg, Wwg, Wwg, Wwg, Xu, Xu, Xu, Xu, Xu, Xu, Xu, Xu, Xu, Xu, Xu, Xu, Xu, Xu, Xu, Uh, Uu, Ur, Ur, Uh, Xu, Xu, Xu, Xu
Xu, Xu, Xu, Xu, Xu, Xu, Xu, Xu, Xu, Xu, Xu, Xu, Xu, Xu, Xu, Xu, Xu, Xu, Xu, Uu, Ur, Xu, Xu, Xu, Xu, Xu, Xu, Xu, Xu, Wwf, Xu, Ss, Wwf, Wwg, Wwf, Wwg, Ss, Ss, Wwg, Wwg, Wwg, Wwg, Wwg, Xu, Xu, Xu, Xu, Xu, Xu, Xu, Xu, Xu, Xu, Xu, Xu, Xu, Uh, Uu, Ur, Ur, Uu, Uh, Xu, Xu, Xu, Xu
Xu, Xu, Xu, Xu, Xu, Xu, Xu, Xu, Xu, Xu, Xu, Xu, Xu, Xu, Xu, Xu, Xu, Xu, Ur, Ur, Xu, Xu, Xu, Xu, Xu, Xu, Xu, Xu, Xu, Xu, Ss, Wwg, Wwf, Wwf, Wwf, Wwg, Ss, Wwg, Wwf, Ss, Wwf, Wwf, Ss, Wwg, Xu, Xu, Xu, Xu, Xu, Xu, Xu, Xu, Xu, Xu, Xu, Xu, Uh, Uu, Uu, Ur, Uh, Uh, Xu, Xu, Xu, Xu
Xu, Xu, Xu, Xu, Xu, Xu, Xu, Xu, Xu, Xu, Xu, Xu, Xu, Uh, Uh, Uh, Uu, Ur, Ur, Xu, Xu, Xu, Xu, Xu, Xu, Xu, Xu, Xu, Xu, Xu, Xu, Wwg, Ss, Ss, Wwg, Ss, Wwf, Wwg, Wwg, Wwf, Wwg, Wwg, Wwg, Xu, Ss, Xu, Xu, Xu, Xu, Xu, Xu, Xu, Xu, Xu, Xu, Xu, Xu, Uh, Uh, Uu, Qxu, Xu, Xu, Xu, Xu, Xu
Xu, Xu, Xu, Xu, Xu, Xu, Xu, Xu, Xu, Xu, Xu, Xu, Uh, Uh, Uu, Uu, Ur, Ur, Xu, Uh, Xu, Xu, Xu, Xu, Xu, Xu, Xu, Xu, Xu, Xu, Xu, Wwg, Wwf, Wwf, Wwf, Wwg, Wwg, Wwg, Ss, Wwg, Wwg, Ss, Wwg, Wwg, Wwg, Xu, Xu, Xu, Xu, Xu, Xu, Xu, Xu, Xu, Xu, Xu, Xu, Xu, Qxu, Qxu, Xu, Xu, Xu, Xu, Xu, Xu
Xu, Xu, Xu, Xu, Xu, Xu, Xu, Xu, Xu, Xu, Xu, Uh, Uh, Uu, Ce, Ur, Ur, Uu, Uh, Uh, Uh, Xu, Xu, Xu, Xu, Xu, Xu, Xu, Xu, Xu, Xu, Xu, Xu, Ss, Wwf, Ss, Wwg, Ss, Wwg, Sm, Wwf, Wwg, Wwg, Wwf, Wwg, Wwg, Xu, Xu, Xu, Xu, Xu, Xu, Xu, Xu, Xu, Xu, Xu, Uh, Uu, Qxu, Uu, Xu, Xu, Xu, Xu, Xu
Xu, Xu, Xu, Xu, Xu, Xu, Xu, Xu, Xu, Xu, Uh, Uh, Uu, Ce, 1 Ke, Ce, Uu, Uh, Uh, Uh, Xu, Xu, Xu, Xu, Xu, Xu, Xu, Xu, Xu, Xu, Xu, Xu, Xu, Sm, Wwg, Wwf, Wwg, Wwg, Wwf, Wwg, Wwf, Wwg, Ss, Wwg, Wwg, Wwf, Xu, Xu, Xu, Xu, Xu, Xu, Xu, Xu, Xu, Xu, Xu, Uh, Uh, Uu, Uh, Xu, Xu, Xu, Xu, Xu
Xu, Xu, Xu, Xu, Xu, Xu, Xu, Xu, Xu, Xu, Uh, Uh, Uu, Ce, Ce, Ce, Uh, Uh, Uh, Xu, Xu, Xu, Xu, Xu, Xu, Xu, Xu, Xu, Xu, Xu, Xu, Xu, Xu, Xu, Xu, Ss, Wwf, Ss, Wwf, Wwg, Wwg, Wwf, Wwg, Wwf, Wwf, Wwf, Xu, Xu, Xu, Xu, Xu, Xu, Xu, Xu, Xu, Xu, Xu, Xu, Xu, Uh, Xu, Xu, Xu, Xu, Xu, Xu
Xu, Xu, Xu, Xu, Xu, Xu, Uh, Uh, Uh, Uh, Uu, Uu, Ur, Ur, Ur, Uu, Uh, Uh, Xu, Xu, Xu, Xu, Xu, Xu, Xu, Xu, Xu, Xu, Xu, Xu, Xu, Xu, Xu, Xu, Xu, Wwg, Xu, Wwg, Wwf, Wwf, Wwf, Wwf, Ss, Wwg, Wwf, Wwg, Wwg, Xu, Xu, Xu, Xu, Xu, Xu, Xu, Xu, Xu, Xu, Xu, Xu, Xu, Xu, Xu, Xu, Xu, Xu, Xu
Xu, Xu, Xu, Xu, Xu, Xu, Uh, Uu, Uu, Uu, Uu, Ur, Uu, Ur, Uu, Uu, Uu, Uh, Xu, Xu, Xu, Xu, Xu, Xu, Xu, Xu, Xu, Xu, Xu, Xu, Xu, Xu, Xu, Xu, Xu, Xu, Xu, Ss, Xu, Wwg, Wwg, Wwg, Wwf, Wwf, Wwf, Ss, Xu, Xu, Xu, Xu, Xu, Xu, Xu, Xu, Xu, Xu, Xu, Xu, Xu, Xu, Xu, Xu, Xu, Xu, Xu, Xu
