border_size=1
usage=map

Ha, Ha, Ha, Ha, Ai, Ha, Ha, Aa, Ha, Ai, Aa^Fpa, Aa, Rb, Ai, Ha^Fpa, Aa, Ms, Ms, Ha^Fpa, Ha, Ms, Ha, Ms, Aa^Fpa, Ms^Xm, Ms, Ms^Xm, Ms, Ms^Xm, Ms, Ms^Xm, Rb, Ms, Ha, Ms, Aa, Aa, Aa, Ms, Ha, Ha^Fpa
Ha^Fma, Aa, Aa, Ms, Ms, Rb, Ms, Ha, Ms, Ms, Ms^Xm, Ms, Ms^Xm, Ms, Ms^Xm, Ms, Ms^Xm, Ms, Ms, Ai, Ms, Ms, Ms^Xm, Ms^Xm, Ms^Xm, Ms^Xm, Ms^Xm, Ms^Xm, Ms, Ms^Xm, Ms^Xm, Ms^Xm, Ms^Xm, Ms^Xm, Ms^Xm, Ms, Ms, Ha, Ms, Aa^Fpa, Aa
Aa, Ha, Ms, Ha^Fpa, Ms^Xm, Ms, Ms^Xm, Ms^Xm, Ms^Xm, Ms^Xm, Ms^Xm, Ms^Xm, Ms, Ms^Xm, Ms^Xm, Ms^Xm, Ms^Xm, Ms^Xm, Ms^Xm, Ms^Xm, Ms^Xm, Ms^Xm, Ms, Ms^Xm, Ms^Xm, Ms^Xm, Ms, Ms, Aa^Fma, Ms, Ms, Ms^Xm, Ms^Xm, Ms, Ms^Xm, Ms^Xm, Ms^Xm, Ms, Ms^Xm, Ms, Ha
Ms^Xm, Ms^Xm, Ms^Xm, Ms^Xm, Ms^Xm, Ms^Xm, Ms^Xm, Ms^Xm, Ms, Ms^Xm, Ms, Ms^Xm, Ms^Xm, Ms, Ms, Ms^Xm, Ms^Xm, Ms^Xm, Ms, Ms^Xm, Ms, Ms, Ms, Ms, Ms, Ms^Xm, Ms, Ms, Ms, Ms, Ms, Ms^Xm, Ms, Ms, Ms, Ms^Xm, Ms^Xm, Ms^Xm, Ms^Xm, Ms^Xm, Ms^Xm
Ms, Ms^Xm, Ms, Ms^Xm, Ms, Ms^Xm, Ms, Ms, Ms, Ms, Ms, Ms, Ms, Ms^Xm, Ms, Ms, Ms, Ms, Ms, Ms, Ms, Ms, Ms, Ms, Ms, Ms, Ms, Ms, Ms, Ms, Ms, Ms, Ha^Fpa, Ms, Ms, Ms, Ms, Ms^Xm, Ms^Xm, Ms^Xm, Ms
Ha^Fpa, Ms, Ha, Ms, Ha^Fpa, Ms, Ms, Ha^Fpa, Ha, Ha, Ha, Ha^Fpa, Ms, Ms, Ms, Ms, Ha^Fpa, Ms, Ha, Aa, Ha^Fpa, Ha^Fpa, Ha, Ms, Aa, Ha^Fpa, Ha^Fpa, Ha, Ha, Ha^Fpa, Ha, Ha^Fpa, Ha, Ha^Fpa, Ha, Ms, Ha^Fpa, Ms, Ms, Ms, Ai
Ai, Ha^Fpa, Aa^Fma, Ha, Ha^Fpa, Ms, Ha^Fpa, Ha, Ms, Ha^Fpa, Ms, Ms, Aa, Ha^Fpa, Ha^Fpa, Ha^Fpa, Aa^Fpa, Ms, Ms, Ha^Fpa, Aa^Fpa, Ha, Ha^Fpa, Ms, Aa^Fpa, Aa, Ha, Ms, Ms, Ha^Fpa, Ha, Ha^Fpa, Ha, Ha^Fpa, Ms, Ha^Fpa, Aa, Ha, Ha^Fpa, Ms, Aa
Ha, Rb, Ha, Ha, Ha, Rb, Aa^Fpa, Aa, Aa, Ha, Ha, Aa^Fma, Ha^Fpa, Rb, Ms, Ms, Ha, Ms, Aa, Ha^Fpa, Aa, Ai, Ai, Aa, Aa, Ai, Ms, Ms, Ha, Ha^Fda, Aa, Aa, Aa^Fpa, Ha, Aa, Aa, Ai, Aa, Ha^Fpa, Ha, Ha^Fpa
Aa, Ha, Ai, Aa^Fpa, Aa, Aa^Fpa, Aa, Aa, Rb, Ai, Ha, Ha, Ha^Fpa, Ha, Ms, Aa, Ms, Ms, Ms, Ha, Aa, Ha, Rb, Ms, Ha, Ms, Aa^Fpa, Aa^Fpa, Aa, Aa^Fpa, Aa^Fpa, Aa^Fpa, Aa, Aa^Fpa, Aa^Fpa, Aa^Fpa, Ms, Rb, Ha, Ha, Aa^Fpa
Ha, Aa, Ms, Aa^Fpa, Ai, Ha^Fpa, Ha, Ha^Fpa, Aa, Aa^Fpa, Ai, Aa, Aa, Ha^Fpa, Ha, Ms, Ms, Ms, Aa, Ha, Ha, Ha^Fpa, Ha^Fpa, Aa, Ha^Fpa, Aa, Aa, Aa, Aa, Aa, Aa, Aa, Aa, Aa^Fpa, Aa, Aa^Fpa, Aa, Aa, Aa, Rb, Rb
Ha, Ha^Fpa, Ha, Aa, Ha^Fpa, Aa, Ha^Fpa, Ms, Aa, Ms, Ha, Ha, Ha^Fpa, Ai, Ha, Aa, Ms^Xm, Ha, Ms, Aa, Ha, Ms, Aa, Aa, Aa, Aa, Aa, Aa, Aa, Aa, Aa, Ha, Aa, Aa, 1 Aa, Aa, Rb, Rb, Rb, Rb, Aa
Ha, Aa, Ha, Ha, Aa, Ha, Aa^Fpa, Aa^Fpa, Aa^Fpa, Aa^Fpa, Aa^Fpa, Rb, Ha^Fpa, Aa, Ai, Ms, Ms^Xm, Ms, Ha, Ha, Aa^Fpa, Aa^Fpa, Aa^Fpa, Aa^Fpa, Ai, Aa^Fpa, Rb, Aa, Ha, Ha, Ha^Fpa, Aa, Aa, Aa^Fpa, Aa, Aa, Aa, Aa, Aa, Aa, Aa^Fpa
Ha, Ha, Ha, Aa, Aa^Fpa, Ha, Aa, Aa, Aa, Aa, Aa, Aa, Rb, Ha, Ms, Ms^Xm, Ms, Ms, Aa, Ha, Aa, Aa^Fpa, Ai, Ai, Rb, Ha, Aa, Aa, Ha, Ha, Aa, Aa, Aa, Aa, Aa, Aa, Ms, Ms, Ms, Aa^Fpa, Aa
Aa, Aa, Aa, Aa, Aa, Aa, Aa, Aa, Rb, Ha, Aa, Aa, Aa, Ha, Aa, Ms, Ai, Ha, Aa, Aa, Ai, Aa, Aa, Rb, Aa, Rb, Aa, Aa, Aa, Aa, Aa, Aa, Aa^Fpa, Aa, Ms, Aa, Aa, Aa, Ha, Ha^Fpa, Ha
Rb, Rb, Aa, Ha, Ai, Ai, Aa, Rb, Aa, Rb, Aa, Aa, Ha^Fpa, Aa, Aa, Aa, Aa, Aa, Aa, Ha, Rb, Aa, Aa, Aa, Aa^Fpa, Aa, Ha, Ha, Aa, Aa, Aa, Ha, Ai, Ms, Aa, Ha, Ha, Ms, Ms, Ms, Ms
Aa, Aa, Aa, Rb, Rb, Aa, Ha, Aa, Aa, Aa, Rb, Ha^Fpa, Aa, Rb, Ms, Aa, Ha, Ai, Ha, Ha, Aa, Aa^Fpa, Aa, Aa^Fma, Ai, Aa^Fpa, Ha, Rb, Aa, Ha, Aa^Fpa, Aa^Fpa, Aa^Fpa, Aa, Ha, Ai, Ha^Fpa, Ha, Ha^Fpa, Ms, Ms
Ms, Ai, Aa, Aa, Ai, Aa, Aa, Aa, Ha, Aa, Aa^Fpa, Aa, Aa^Fpa, Aa, Aa^Fpa, Ha, Ha, Aa^Fpa, Ms^Xm, Ms^Xm, Ms, Ha, Ha, Aa, Ms, Rb, Aa, Rb, Aa^Fpa, Aa^Fpa, Ms, Aa, Aa, Ms, Aa, Ha^Fpa, Ha^Fda, Ms, Ms, Ai, Ms
Ha, Ai, Aa, Ai, Ai, Ha, Ha, Aa^Fpa, Ha, Ha, Ms, Aa^Fpa, Ha, Ha, Aa, Aa^Fpa, Ha, Ms, Ms^Xm, Ms^Xm, Ms, Ha, Ms, Ai, Aa, Ha, Aa, Aa, Rb, Ai, Ha, Ms, Aa, Ha, Ai, Ms, Ai, Ha, Ms, Ha, Rb
Ha^Fpa, Ha^Fpa, Ha, Aa, Ha, Ha^Fpa, Aa, Ms, Aa, Aa, Aa^Fpa, Aa^Fma, Ha, Aa, Ha^Fpa, Aa, Ms, Ms, Ms, Ms, Ha, Ha, Aa, Aa, Ha, Ms, Ha, Ha, Aa, Ha, Ha, Ha, Ai, Ha^Fpa, Ms, Aa, Ha, Ha, Ai, Ha^Fma, Ha^Fma
Ms, Ha, Ha, Ha, Ha^Fpa, Ha^Fpa, Ha, Ha, Ha^Fpa, Ha, Ha, Aa, Aa, Rb, Aa, Aa^Fpa, Rb, Aa, Ms, Ms, Ha, Aa, Aa, Ms, Ha, Rb, Aa, Ms, Ha^Fda, Aa, Aa^Fpa, Ms, Rb, Ha, Ha, Ai, Ha^Fpa, Aa, Ha^Fpa, Ha^Fpa, Aa
Ms^Xm, Ms, Ms, Ha^Fpa, Ms, Ms, Ha, Rb, Ha, Ms, Ha, Ha^Fpa, Rb, Ha, Ha, Ms, Aa^Fpa, Ha^Fda, Aa, Aa, Aa, Ha, Aa, Ha^Fpa, Ha, Ha^Fpa, Rb, Rb, Ms, Aa, Ms, Ha^Fpa, Ms, Ha^Fpa, Ha^Fpa, Ha^Fpa, Ms, Ha, Ms, Ha, Ai
Ms, Ms^Xm, Ms, Ha^Fpa, Ha^Fpa, Ha, Ha^Fpa, Ha, Ha^Fpa, Ha, Aa^Fpa, Ms, Ha^Fpa, Aa, Ha, Ms, Ha^Fda, Ha, Ms, Ha, Ha^Fpa, Aa^Fma, Ha^Fpa, Ha, Ha^Fpa, Ha^Fpa, Ha, Aa, Ha^Fpa, Aa, Ha^Fpa, Ha, Ai, Aa^Fpa, Ms, Ms, Ms, Ms, Ms, Ms, Ms^Xm
Ha, Ms^Xm, Ms^Xm, Ms, Ms, Ha^Fma, Ms, Ms, Ms, Ha, Ha^Fpa, Ha^Fpa, Ms, Ha^Fpa, Ha^Fpa, Ha, Ms, Aa, Ha^Fma, Ha^Fpa, Ha, Ha^Fpa, Ha^Fpa, Ha, Ha, Aa, Ha^Fpa, Ha^Fpa, Aa^Fpa, Ha^Fpa, Ha, Ms, Ms, Ms, Ms^Xm, Ms^Xm, Ms^Xm, Ms^Xm, Ms^Xm, Ms^Xm, Ms
Ms, Ms^Xm, Ms^Xm, Ms, Ms^Xm, Ms, Ms, Ha, Ha, Ms, Ms, Ms, Ha^Fpa, Ms, Ms, Ms, Ms, Ms, Ms, Ms, Ms, Ha^Fpa, Ms, Aa^Fpa, Ha, Ms, Ms, Ha^Fpa, Ms^Xm, Ms^Xm, Ms^Xm, Ms^Xm, Ms^Xm, Ms^Xm, Ms, Ms^Xm, Ms, Ms^Xm, Ms, Ms, Ms
Ms, Ms, Ms, Ms^Xm, Ms^Xm, Ms, Ms, Ms, Ms, Ms, Ha^Fpa, Ms, Ms, Ha^Fpa, Ha^Fpa, Ha^Fpa, Ms, Ha^Fpa, Ms, Ha^Fpa, Ms^Xm, Ms, Ms^Xm, Ms^Xm, Ms^Xm, Ms^Xm, Ms^Xm, Ms^Xm, Ms^Xm, Ms, Ms, Ms, Ms, Ms, Ms, Ms, Ms, Ms, Ms, Ms, Ms
Ai, Ms, Ms, Ms, Ms^Xm, Ms^Xm, Ms^Xm, Ms^Xm, Ms^Xm, Ms, Ms^Xm, Ms, Ms^Xm, Ms, Ms^Xm, Ms, Ms^Xm, Ms^Xm, Ms^Xm, Ms^Xm, Ms^Xm, Ms^Xm, Ms, Ms, Ms, Ms, Ms, Ms, Ms, Ms, Aa^Fpa, Ms, Ms, Ms, Ms, Ms, Ms, Ms, Ms, Ms, Ms
Aa^Fma, Ha, Ms, Ms, Ms, Ms, Ms, Ms^Xm, Ms, Ms^Xm, Ms, Ms^Xm, Ms, Ms^Xm, Ms, Ms^Xm, Ms, Ms, Ms, Ms, Ms, Ms, Ms, Ms, Ms, Ms, Ms, Ms, Ha, Ms, Ha^Fpa, Ms, Ms, Ms, Ms, Ms, Ms, Ms, Ha, Ms, Ha
