border_size=1
usage=map

Ms, Ms, Ww, Ww, Ww, Ww, Ww, Ww, Ww, Ww, Ww, Ww, Ai, Ai, Ai, Ai, Ww, Aa, Aa, Ww, Ww, Ww, Aa, Aa, Aa, Ms, Ms
Ms, Ms, Ww, Ww, Ww, Ww, Ww, Ww, Aa, Ww, Ww, Ww, Ww, Ai, Ai, Ai, Ai, Aa, Aa, Ww, Aa, Ww, Aa, Aa, Aa, Ms, Ms
Ms, Ai, Ww, Ai, Ww, Ww, Aa, Ai, Ai, Ai, Ai, Ww, Ww, Ww, Ww, Ai, Ai, Ai, Ai, Ww, Aa, Aa, Aa, Aa, Aa, Aa, Aa
Ww, Ai, Ww, Ww, Aa, Aa, Ai, Ai, Ww, Ww, Ww, Ww, Ww, Ww, Ww, Ww, Ww, Ww, Ww, Aa, Aa^Voa, Aa, Aa, Aa, Aa, Aa, Aa
Ai, Ww, Ww, Ww, Ww, Ai, Ww, Ww, Ww, Ww, Ai, Ww, Ai, Ai, Ai, Ww, Ww, Ww, Ww, Aa, Aa, Aa, Aa, Aa, Aa, Aa^Voa, Aa
Ms, Ai, Ai, Ww, Ww, Ww, Ai, Ww, Ai, Ai, Aa, Ai, Ww, Ww, Ww, Ai, Ww, Ww, Ai, Ww, Aa, Aa, Aa^Voa, Aa, Aa, Aa, Aa
Ms, Ww, Ss, Ww, Ww, Ss, Ww, Aa, Aa, Aa, Ss, Ai, Aa, Ww, Ww, Ww, Ww, Ww, Ww, Ai, Ai, Aa, Aa, Aa, Aa, Aa, Aa
Ai, Ai, Ww, Rb, Rb, Ww, Ss, Ww, Rb, Ww, Ww, Rb, Ww, Aa, Aa, Ai, Aa, Aa, Aa, Aa, Ww, Aa, Cea, Cea, Cea, Aa, Aa
Ms, Ai, Rb, Ss, Ss, Ww, Ww, Ss, Ss, Ww, Ss, Ss, Rb, Ww, Ai, Ai, Ww, Ai, Ai, Ww, Ai, Cea, Cea, 1 Kea, Cea, Aa, Aa
Ai, Ai, Ai, Ww, Rb, Rb, Rb, Ss, Rb, Ss, Rb, Ss, Ss, Ww, Ww, Ww, Ww, Ww, Ww, Ai, Ww^Bw/r, Aa, Ai, Cea, Aa, Aa, Aa
Ms, Ms, Ms, Ai, Ai, Ss, Ss, Rb, Rb, Ss, Rb, Rb, Ss, Ss, Ww, Ww, Ww, Ww, Aa, Ai, Ww, Ww, Ai, Aa, Aa, Aa, Aa
Ms, Ms, Ms, Ms, Aa, Ai, Ss, Rb, Chs, Aa, Ai, Ss, Ss, Rb, Rb, Ww, Wwf, Aa, Ai, Ai, Ww, Aa, Aa, Ai, Ww, Aa, Ww
Aa, Aa, Aa, Aa, Aa, Ss, Ss, Ss, 2 Khs, Chs, Ss, Ss, Aa, Ss, Rb, Ss, Rb, Wwf, Aa, Aa, Ai, Ww, Ai, Ww, Ai, Ai, Ww
Aa, Aa, Aa, Aa, Aa, Ss, Ss, Ss, Chs, Chs, Ss, Ss, Ss, Rb, Ss, Rb, Rb, Rb, Ww, Wwf, Ai, Ww, Ww, Ww, Ai, Ai, Ai
Aa, Aa, Rb, Rb, Ss, Ss, Aa, Ss^Vhs, Ss, Rb, Rb, Ss, Ss, Aa, Aa, Ss, Rb, Wwf, Ww, Wwf, Ai, Ww, Ww, Ww, Ww, Ww, Ai
Rb, Aa, Ss, Aa, Ss, Ss, Ss, Aa, Ai, Ss, Rb, Ss, Chs, Aa, Ss, Ss^Vhs, Ss, Rb, Wwf, Ai, Ww, Ww, Ww, Ww, Ww, Wo, Ai
Aa, Aa, Aa, Aa, Ss, Ss, Aa, Aa, Ss, Ss, Ss^Vhs, Ss, Ss, Ss, Rb, Rb, Rb, Rb, Rb, Ai, Ww, Wwf, Ww, Wo, Ww, Wo, Wo
Aa, Aa, Rb, Ss, Ss, Rb, Rb, Ss, Ss, Rb, Ss, Rb, Ss, Rb, Rb, Aa, Ss, Wwf, Ww, Aa, Wwf, Wwf, Aa, Ww, Ww, Wo, Wo
Ms, Ss, Rb, Ss, Rb, Ss, Ss, Chs, Ss, Rb, Aa, Rb, Rb, Ss, Wwf, Ss, Wwf, Wwf, Ww, Ww, Wwf, Rb, Ww, Ai, Ai, Wo, Wo
Ms, Ss, Ss, Aa, Ai, Rb, Ss, Ss, Ss, Aa, Ss, Ss, Rb, Ss, Rb, Ww, Rb, Ww, Ai, Aa, Rb, Aa, Ai, Ww, Wo, Wo, Ww
Ww, Ss, Ww, Rb, Ss, Rb, Wwf, Rb, Ss, Ss, Ss, Aa, Rb, Rb, Rb, Wwf, Ww, Ww, Ww, Rb, Ww, Ai, Ai, Wo, Ww, Ai, Ww
Rb, Rb, Wwf, Ss, Ss, Ww, Ss, Aa, Ww, Wwf, Wwf, Ss^Vhs, Rb, Ss, Rb, Ww, Ww, Ww, Ai, Ww, Wo, Wo, Wo, Wo, Ai, Ww, Ww
Wwf, Wwf, Ss, Rb, Ss, Ss, Ss^Vhs, Wwf, Ww, Wwf, Ww, Rb, Ww, Ai, Ww, Ww, Ww, Ai, Ai, Wo, Ai, Ww, Ww, Ai, Rb, Ww, Ww
Ai, Ww, Aa, Ss, Wwf, Ss, Ss, Wwf, Wwf, Wwf, Wwf, Rb, Ww, Ww, Wo, Ww, Wo, Wo, Wo, Wo, Ww, Aa, Rb, Ww, Aa, Ww, Ww
Wo, Wo, Wo, Ai, Ww, Ww, Ai, Aa, Ai, Ww, Aa, Wwf, Ww, Ww, Ww, Wo, Ww, Ai, Ww, Ww, Rb, Aa, Rb, Rb, Aa, Aa, Aa
Ww, Ww, Wo, Ai, Wo, Wo, Aa, Aa, Ww, Ww, Aa, Ai^Bw\r, Wo^Bw\r, Wo, Wo, Wo, Ww, Ww, Ww, Ww, Ww, Aa, Ww, Aa, Ww, Ww, Ww
Wwf, Wwf, Ww, Wo, Ww, Wo, Wo, Ai, Wo, Ww, Ai, Ai, Wo, Ai^Bw\r, Ai, Ww, Ai, Ww, Ww, Aa, Ww, Ww, Ww, Ww, Chw, Wwf, Wwf
Wwf, Wwf, Wwf, Ww, Ww, Ai, Ai, Wo, Ww, Wo, Ww, Ai, Ww, Wwf, Rb, Ww, Ww, Ww, Chw, Ww, Chw, Chw, Chr, Chw, Ai, Ai, Wwf
Aa, Aa, Aa, Ww, Wwf, Ww, Ww, Ww, Ww, Ww, Ww, Ww, Rb, Ww, Rb, Wwf, Ww, Ww, Wwf, Ww, Chr, Aa, Ai, Chr, Rb, Ai, Wwf
Aa, Aa, Rb, Rb, Ai, Wwf, Ww, Ww, Wwf, Ww, Ww, Wwf, Ai, Rb, Aa, Rb, Wwf, Wwf, Ai, Wwf, Rb, 3 Khr, Rb, Rb, Rrc^Vhca, Ai, Ai
Aa, Rb, Aa, Rb, Aa, Wwf, Ai, Ai, Wwf, Wwf, Ai, Wwf, Wwf, Ww, Rb, Rb, Aa, Aa, Rb, Aa, Rb, Rb, Rb, Aa, Aa, Ai, Rb
Aa, Aa, Aa, Aa, Aa, Aa, Rb, Ai, Rb, Ai, Rb, Aa, Rb, Ai, Rb, Rb, Rb, Rb, Aa, Rb, Rrc^Vhca, Aa, Rb, Aa, Aa, Ai, Aa
Aa, Aa, Rb, Rb, Aa, Aa, Rb, Wwf, Aa, Rb, Ai, Aa^Voa, Aa, Aa, Rb, Rb, Rb, Rb, Rb, Ai, Rb, Rb, Rb, Aa, Rb, Ai, Aa
Aa, Aa, Rb, Aa, Aa, Rb, Aa, Aa, Aa, Rb, Rb, Rb, Rb, Rb, Aa, Aa, Rb, Rb, Rb, Rb, Rb, Rb, Rb, Rb, Aa, Ai, Ai
Aa, Rb, Aa, Aa, Aa, Aa, Aa, Aa, Aa, Rb, Aa, Aa, Aa, Rb, Rb, Rb, Rb, Ai, Aa, Aa, Aa, Aa, Aa, Aa, Aa, Aa, Aa
