border_size=1
usage=map

Rb          , Aa          , Aa          , Aa          , Aa          , Aa          , Aa          , Aa          , Aa          , Aa          , Aa          , Aa          , Aa          , Aa          , Aa          , Aa          , Aa          , Aa          , Ss          , Ss          , Ai          , Ss          , Ss          , Aa          , Ai          , Ai          , Aa          , Aa          , Ss          , Ss          , Ss          , Ss          , Ss          , Aa          , Aa          , Aa          , Ss          , Ss          , Aa          , Aa          , Aa          , Aa          , Aa          , Ss          , Ss          , Ss          , Ss          
Aa          , Aa          , Rb          , Aa          , Aa          , Aa          , Aa          , Aa          , Aa          , Aa          , Aa          , Aa          , Aa          , Aa          , Aa          , Aa          , Aa          , Aa          , Ai          , Ss          , Aa          , Aa          , Aa          , Ai          , Ai          , Aa          , Aa          , Aa          , Ss          , Ss          , Ss          , Ss          , Ss          , Aa          , Aa          , Aa          , Aa          , Ss          , Ss          , Aa          , Aa          , Aa          , Aa          , Aa          , Aa          , Ss          , Ss          
Aa          , Aa          , Aa          , Aa          , Rb          , Aa          , Aa          , Cea         , Cea         , Cea         , Cea         , Cea         , Aa          , Aa          , Aa          , Aa          , Aa          , Aa          , Ai          , Aa          , Ai          , Ai          , Ai          , Ai          , Aa          , Aa          , Aa          , Aa          , Aa          , Ss          , Ss^Vhs      , Ss          , Ss          , Aa          , Aa          , Aa          , Aa          , Aa          , Ai          , Aa          , Ai          , Aa          , Aa          , Aa          , Aa          , Aa          , Ss          
Aa          , Aa          , Aa          , Aa          , Rb          , Aa          , Aa          , Cea         , Cea         , 1 Kea       , Cea         , Cea         , Aa          , Aa          , Aa          , Aa          , Aa          , Aa          , Ai          , Ai          , Ch          , Aa          , Aa          , Aa          , Aa          , Aa          , Aa          , Aa          , Aa          , Ss          , Ss          , Ss          , Ss          , Ss          , Ss          , Aa          , Ai          , Ai          , Aa          , Ai          , Ch          , Ai          , Rrc^Vhca    , Aa          , Aa          , Aa          , Ss          
Aa          , Aa          , Aa          , Aa          , Rrc^Vhca    , Rb          , Aa          , Aa          , Aa          , Cea         , Aa          , Aa          , Aa          , Aa          , Aa          , Aa          , Aa          , Ai          , Ss          , Ss          , Ai          , Ss          , Ss          , Aa          , Aa          , Aa          , Aa          , Aa          , Aa          , Ss          , Ss          , Ss          , Ss          , Ss          , Ss          , Ai          , Ai          , Aa          , Aa          , Aa          , Ai          , Ai          , Ai          , Ai          , Ai          , Ss          , Ss          
Aa          , Aa          , Aa          , Aa          , Aa          , Rb          , Rb          , Aa          , Aa          , Aa          , Aa          , Aa          , Aa          , Aa          , Aa          , Aa          , Aa          , Ai          , Ss          , Ss          , Ss          , Ss          , Ai          , Aa          , Aa          , Aa          , Aa          , Aa          , Ss          , Ss          , Ss          , Ss          , Ss          , Ss          , Ai          , Ai          , Aa          , Ai          , Ai          , Ai          , Ai          , Ai          , Ai          , Ai          , Ss          , Ai          , Ss          
Aa          , Aa          , Aa          , Aa          , Aa          , Aa          , Aa          , Rb          , Aa          , Aa          , Aa          , Aa          , Aa          , Aa          , Aa          , Aa          , Aa          , Ai          , Ss          , Ss          , Ss          , Ss          , Ai          , Ai          , Ai          , Aa          , Ss          , Ss          , Ss          , Ss          , Ss          , Ai          , Ai          , Ai          , Aa          , Ai          , Ai          , Aa          , Ai          , Ai          , Ai          , Aa          , Ai          , Ai          , Ai          , Ai          , Ss          
Aa          , Aa          , Aa          , Aa          , Aa          , Aa          , Aa          , Aa          , Aa          , Aa          , Aa          , Aa          , Aa          , Aa          , Aa          , Aa          , Aa          , Ai          , Ai          , Ai          , Ai          , Ss          , Ai          , Ai          , Ai          , Ss          , Ss          , Ss          , Ss          , Ss          , Aa          , Rrc^Vhca    , Aa          , Aa          , Aa          , Aa          , Aa          , Ai          , Ai          , Ai          , Ai          , Ai          , Ai          , Aa          , Ss          , Ss          , Ss          
Aa          , Aa          , Aa          , Aa          , Aa          , Aa          , Aa          , Aa          , Aa          , Aa          , Aa          , Aa          , Aa          , Aa          , Aa          , Aa          , Aa          , Aa          , Aa          , Ai          , Ai          , Ai          , Aa          , Ai          , Ss          , Ss          , Ss          , Ss          , Ai          , Ai          , Aa          , Aa          , Aa          , Aa          , Aa          , Aa          , Ss          , Ai          , Ai          , Ai          , Ai          , Aa          , Aa          , Aa          , Aa          , Ai          , Ai          
Aa          , Aa          , Aa          , Aa          , Aa          , Aa          , Aa          , Aa          , Aa          , Aa          , Rb          , Ch          , Rrc^Vhca    , Ss          , Aa          , Aa          , Aa          , Aa          , Aa          , Aa          , Aa          , Aa          , Aa          , Aa          , Ss          , Ss          , Ai          , Ai          , Aa          , Aa          , Aa          , Aa          , Ch          , Aa          , Aa          , Aa          , Aa          , Ss          , Ss          , Ss          , Ss          , Aa          , Ai          , Aa          , Aa          , Ai          , Aa          
Aa          , Aa          , Aa          , Aa          , Ss          , Aa          , Aa          , Aa          , Aa          , Aa          , Aa          , Rb          , Rb          , Aa          , Ss          , Aa          , Aa          , Aa          , Aa          , Aa          , Aa          , Aa          , Aa          , Aa          , Ss          , Ss          , Aa          , Aa          , Ch          , Aa          , Aa          , Aa          , Aa          , Aa          , Aa          , Rrc^Vhca    , Aa          , Aa          , Ss          , Ss          , Ss          , Aa          , Aa          , Ai          , Aa          , Aa          , Ss          
Ss          , Ss          , Ss          , Ss          , Aa          , Aa          , Aa          , Aa          , Aa          , Aa          , Aa          , Aa          , Aa          , Aa          , Rb          , Aa          , Aa          , Aa          , Aa          , Ss          , Aa          , Aa          , Aa          , Aa          , Ss          , Ss          , Aa          , Aa          , Aa          , Aa          , Aa          , Aa          , Ch          , Aa          , Aa          , Aa          , Ch          , Aa          , Aa          , Ss          , Ss          , Aa          , Aa          , Aa          , Aa          , Ss          , Ss          
Ss          , Ss          , Ss          , Ss          , Aa          , Aa          , Aa          , Aa          , Aa          , Aa          , Aa          , Aa          , Aa          , Rb          , Aa          , Ss          , Ss          , Aa          , Aa          , Ss          , Ss          , Aa          , Ss          , Ss          , Ss          , Ss          , Aa          , Aa          , Aa          , Aa          , Ch          , Ch          , 2 Kh        , Ch          , Ch          , Aa          , Aa          , Aa          , Aa          , Ss          , Ss          , Aa          , Aa          , Aa          , Aa          , Aa          , Aa          
Ss          , Ss          , Ss          , Ss          , Ss          , Aa          , Aa          , Aa          , Aa          , Aa          , Aa          , Aa          , Aa          , Aa          , Aa          , Aa          , Aa          , Aa          , Aa          , Aa          , Ss          , Ss          , Ss          , Ss          , Ss          , Ss          , Ss          , Aa          , Rrc^Vhca    , Aa          , Ch          , Ch          , Ch          , Ch          , Ch          , Aa          , Aa          , Aa          , Rrc^Vhca    , Ss          , Ss          , Ss          , Ss          , Aa          , Aa          , Aa          , Aa          
Ai          , Ss          , Ss          , Ss          , Aa          , Aa          , Ai          , Aa          , Ai          , Aa          , Ai          , Ss          , Ai          , Aa          , Ai          , Ai          , Aa          , Aa          , Aa          , Aa          , Aa          , Ss          , Ss          , Ss          , Ss          , Ss          , Ss          , Aa          , Aa          , Aa          , Aa          , Ch          , Aa          , Ch          , Aa          , Aa          , Aa          , Aa          , Aa          , Ss          , Ss          , Ss          , Ss          , Ss          , Ss          , Aa          , Aa          
Aa          , Ai          , Ai          , Ai          , Aa          , Ai          , Aa          , Aa          , Ss          , Ai          , Ss          , Ai          , Ai          , Ai          , Aa          , Aa          , Aa          , Aa          , Aa          , Rb          , Rb          , Aa          , Aa          , Ss          , Ai          , Ss          , Ss          , Aa          , Aa          , Aa          , Aa          , Aa          , Aa          , Aa          , Aa          , Aa          , Aa          , Aa          , Aa          , Ss          , Ss          , Ss          , Ss          , Ss          , Ss          , Ss          , Ss          
Aa          , Ai          , Aa          , Aa          , Aa          , Ai          , Aa          , Ai          , Ai          , Ai          , Ai          , Ss          , Ss          , Ss          , Aa          , Ai          , Ai          , Aa          , Aa          , Aa          , Aa          , Rb          , Ch          , Aa          , Ai          , Ai          , Ss          , Aa          , Aa          , Aa          , Aa          , Rrc^Vhca    , Aa          , Aa          , Ai          , Ai          , Ai          , Ai          , Ai          , Ss          , Ss          , Ss          , Ss          , Ss          , Aa          , Aa          , Aa          
Aa          , Ai          , Ai          , Ai          , Ai          , Ai          , Aa          , Aa          , Aa          , Ss          , Ss          , Ai          , Ai          , Ai          , Ai          , Ai          , Ai          , Aa          , Rrc^Vhca    , Aa          , Aa          , Rb          , Rb          , Aa          , Aa          , Ai          , Ai          , Ss          , Ss          , Aa          , Ss          , Aa          , Aa          , Aa          , Ss          , Aa          , Ss          , Ss          , Ss          , Ai          , Ai          , Ss          , Ss          , Ss          , Aa          , Aa          , Aa          
Aa          , Aa          , Aa          , Aa          , Rrc^Vhca    , Aa          , Aa          , Aa          , Aa          , Aa          , Aa          , Aa          , Aa          , Ss          , Ss          , Aa          , Aa          , Aa          , Aa          , Aa          , Aa          , Aa          , Aa          , Rb          , Rb          , Ai          , Ss          , Ss          , Ss          , Ss          , Ai          , Ai          , Ai          , Ss          , Ss          , Ss          , Ss          , Ss          , Ss          , Ss          , Ai          , Ss          , Ss          , Aa          , Aa          , Aa          , Aa          
Ss          , Aa          , Aa          , Aa          , Aa          , Aa          , Ss          , Aa          , Aa          , Aa          , Aa          , Aa          , Aa          , Ss          , Ss          , Ss          , Aa          , Aa          , Aa          , Aa          , Aa          , Aa          , Aa          , Aa          , Aa          , Ai          , Ai          , Ss          , Ai          , Ai          , Ss          , Ai          , Ss          , Ai          , Ai          , Ai          , Aa          , Ai          , Ss          , Ai          , Ss          , Ss          , Aa          , Aa          , Aa          , Aa          , Ss          
Ss          , Ss          , Aa          , Aa          , Aa          , Ch          , Ss          , Ss          , Ss          , Aa          , Aa          , Aa          , Ss          , Ss          , Ss          , Ss          , Ss          , Aa          , Aa          , Aa          , Aa          , Aa          , Aa          , Aa          , Aa          , Ss          , Ss          , Ss          , Ai          , Ss          , Ss          , Ss          , Aa          , Aa          , Aa          , Ai          , Ai          , Aa          , Aa          , Ss          , Ss          , Ss          , Aa          , Aa          , Aa          , Aa          , Ss          
Aa          , Ss          , Aa          , Aa          , Aa          , Ss          , Ss          , Ss          , Ss          , Aa          , Aa          , Aa          , Aa          , Ss          , Ss          , Ss          , Ss          , Ss          , Ss          , Ss          , Ss          , Aa          , Aa          , Aa          , Aa          , Aa          , Ss          , Ss          , Ai          , Ss          , Ss          , Rrc^Vhca    , Aa          , Aa          , Aa          , Ai          , Ai          , Aa          , Aa          , Aa          , Aa          , Aa          , Aa          , Aa          , Aa          , Ss          , Ss          
Aa          , Aa          , Aa          , Aa          , Aa          , Ss          , Ss          , Ss          , Aa          , Aa          , Aa          , Aa          , Aa          , Aa          , Aa          , Ss          , Ss          , Ss          , Ss          , Ss          , Ss          , Aa          , Aa          , Aa          , Aa          , Aa          , Ss          , Ss          , Ss          , Ss          , Ai          , Aa          , Ai          , Ai          , Aa          , Aa          , Ai          , Ai          , Aa          , Aa          , Aa          , Aa          , Aa          , Aa          , Ss          , Ss          , Ss          
Aa          , Aa          , Aa          , Aa          , Aa          , Aa          , Aa          , Aa          , Aa          , Aa          , Aa          , Aa          , Aa          , Aa          , Aa          , Ss          , Ss          , Ss          , Ss          , Ss          , Ss          , Ss          , Ss          , Aa          , Ss          , Ss          , Ss          , Ss          , Ai          , Ai          , Ai          , Ai          , Aa          , Aa          , Ai          , Ai          , Aa          , Aa          , Aa          , Aa          , Aa          , Ss          , Ss          , Ss          , Ss          , Ss          , Ss          
Ss          , Aa          , Aa          , Aa          , Aa          , Aa          , Aa          , Aa          , Aa          , Aa          , Ss          , Ss          , Aa          , Aa          , Aa          , Ss          , Ss          , Ss          , Ai          , Ai          , Ai          , Ai          , Ss          , Ss          , Ss          , Ss          , Ss          , Ss          , Ss          , Ss          , Ss          , Ss          , Ai          , Ai          , Aa          , Aa          , Aa          , Aa          , Aa          , Aa          , Ai          , Ai          , Ss          , Ss          , Ss          , Ss          , Ss          
Ss          , Ss          , Ss          , Aa          , Aa          , Aa          , Rrc^Vhca    , Aa          , Ss          , Ss          , Aa          , Ss          , Ai          , Aa          , Ai          , Ai          , Ai          , Ai          , Ai          , Ss          , Ss          , Ai          , Ss          , Ss          , Ss          , Ss          , Ss          , Ss          , Ss          , Ss          , Ss          , Ss          , Aa          , Aa          , Aa          , Aa          , Aa          , Aa          , Aa          , Aa          , Ai          , Ss          , Aa          , Ss          , Ss          , Ss          , Ss          
Ss          , Ai          , Ai          , Ss          , Ss          , Aa          , Ai          , Aa          , Ai          , Ai          , Ai          , Ai          , Ai          , Ai          , Ai          , Ai          , Ai          , Ai          , Ss          , Ss          , Ss          , Ss          , Ss          , Ss          , Ss          , Ss^Vhs      , Ss          , Ss          , Ss          , Ss          , Ss          , Aa          , Aa          , Aa          , Aa          , Aa          , Ss          , Aa          , Ai          , Ai          , Ss          , Aa          , Aa          , Aa          , Aa          , Ss          , Ss          
Aa          , Aa          , Aa          , Ss          , Ss          , Ai          , Aa          , Ai          , Aa          , Ai          , Aa          , Ch          , Aa          , Aa          , Aa          , Ai          , Ch          , Ss          , Ss          , Ss          , Ss          , Ss          , Ss          , Ss          , Ss          , Ss          , Ss          , Ss          , Ss          , Ss          , Ss          , Aa          , Aa          , Aa          , Ai          , Ss          , Ss          , Ss          , Ai          , Ai          , Ss          , Aa          , Aa          , Aa          , Aa          , Aa          , Aa          
Aa          , Aa          , Aa          , Ss          , Aa          , Aa          , Aa          , Aa          , Aa          , Aa          , Aa          , Aa          , Aa          , Aa          , Rrc^Vhca    , Aa          , Aa          , Aa          , Aa          , Ss          , Ss          , Ss          , Ss          , Ss          , Ss          , Ss          , Ss          , Ss          , Ss          , Ss          , Ai          , Aa          , Ai          , Ai          , Aa          , Aa          , Ss          , Ai          , Ai          , Ss          , Ss          , Ss          , Ss          , Aa          , Aa          , Aa          , Aa          
Aa          , Aa          , Aa          , Aa          , Ai          , Aa          , Rrc^Vhca    , Aa          , Aa          , Aa          , Ch          , Aa          , Aa          , Aa          , Aa          , Aa          , Aa          , Aa          , Aa          , Ss          , Ss          , Ss          , Aa          , Ss          , Aa          , Ss          , Ss          , Ss          , Ss          , Ss          , Ss          , Ai          , Ss          , Aa          , Aa          , Rb          , Ch          , Ss          , Ai          , Ss          , Ss          , Ss          , Ss          , Ss          , Ss          , Aa          , Ss          
Ss          , Aa          , Aa          , Aa          , Ai          , Aa          , Aa          , Aa          , Aa          , Ss          , Ch          , 3 Kh        , Ch          , Ss          , Aa          , Aa          , Aa          , Aa          , Ss          , Ss          , Ss          , Aa          , Aa          , Aa          , Aa          , Aa          , Aa          , Ss          , Ai          , Ai          , Ss          , Ss          , Ss          , Aa          , Aa          , Rb          , Rb          , Ai          , Ss          , Ai          , Ss          , Ss          , Ss          , Ss^Vhs      , Ss          , Ss          , Ss          
Ss          , Ss          , Aa          , Ss          , Ai          , Aa          , Aa          , Aa          , Aa          , Aa          , Ss          , Ch          , Ss          , Ss          , Aa          , Aa          , Ss          , Ss          , Ss          , Ss          , Ss          , Aa          , Aa          , Aa          , Aa          , Aa          , Aa          , Ai          , Ai          , Ss          , Ai          , Ss          , Ss          , Ss          , Ai          , Aa          , Aa          , Aa          , Aa          , Ai          , Aa          , Ss          , Ss          , Ss          , Ss          , Ss          , Ss          
Aa          , Aa          , Aa          , Aa          , Ai          , Ai          , Ss          , Aa          , Aa          , Aa          , Aa          , Aa          , Aa          , Aa          , Aa          , Aa          , Ss          , Ss          , Ss          , Ss          , Ss          , Ss          , Ss          , Aa          , Aa          , Aa          , Aa          , Ai          , Ai          , Aa          , Aa          , Ss          , Ai          , Ai          , Ai          , Aa          , Aa          , Aa          , Ai          , Ai          , Aa          , Aa          , Aa          , Ss          , Ss          , Ss          , Ss          
Aa          , Aa          , Ai          , Ai          , Aa          , Aa          , Aa          , Aa          , Rrc^Vhca    , Aa          , Aa          , Aa          , Aa          , Rrc^Vhca    , Aa          , Aa          , Ss          , Ss          , Ss          , Ss          , Ss          , Ss          , Ss          , Aa          , Aa          , Aa          , Aa          , Aa          , Ai          , Aa          , Ai          , Ai          , Aa          , Ss          , Ss          , Ai          , Ai          , Ai          , Ai          , Aa          , Aa          , Rb          , Rb          , Aa          , Ss          , Ss          , Ss          
Ss          , Aa          , Ss          , Ai          , Aa          , Aa          , Aa          , Aa          , Aa          , Aa          , Aa          , Aa          , Aa          , Aa          , Ss          , Ss          , Ai          , Ss          , Ss          , Ss          , Ss          , Ss          , Ss          , Aa          , Aa          , Aa          , Aa          , Ss          , Ss          , Ai          , Ai          , Ai          , Ai          , Ai          , Ai          , Ai          , Ss          , Ss          , Ss          , Aa          , Ss          , Rrc^Vhca    , Rb          , Aa          , Aa          , Aa          , Aa          
Ss          , Ss          , Aa          , Aa          , Aa          , Ai          , Ai          , Ai          , Ai          , Ss          , Ss          , Ss          , Ai          , Ss          , Ai          , Ai          , Ss          , Ss          , Ss          , Ss          , Ss          , Ss          , Ss          , Aa          , Aa          , Aa          , Aa          , Aa          , Aa          , Ss          , Aa          , Aa          , Aa          , Ss          , Ss          , Ss          , Ss          , Ss          , Ss          , Ss          , Ss          , Aa          , Aa          , Rb          , Rb          , Aa          , Aa          
Ss          , Ss          , Aa          , Aa          , Aa          , Aa          , Aa          , Aa          , Aa          , Ai          , Ss          , Ai          , Ss          , Ai          , Ss          , Ss          , Ss          , Ss          , Ss          , Ss          , Ss          , Ss          , Ss          , Ss          , Aa          , Aa          , Aa          , Aa          , Aa          , Aa          , Aa          , Aa          , Aa          , Ss          , Ss          , Ss          , Ss          , Ss          , Ss          , Ss          , Ss          , Ss          , Aa          , Aa          , Aa          , Rb          , Aa          
