border_size=1
usage=map

Rb, Rb, Rb, Aa, Aa, Aa, Aa, Aa, Aa, Aa, Aa^Fpa, Aa, Ha, Ha, Ha, Aa, Aa^Fpa, Aa^Fpa, Aa, Aa, Aa^Fpa, Aa, Aa^Fpa, Aa, Aa, Aa, Aa, Aa, Aa, Aa, Aa, Aa, Ha, Aa^Fpa, Ha, Aa, Aa^Fpa, Aa^Fpa, Aa^Fpa, Aa, Ha, Aa^Fpa, Ha, Aa^Fpa, Aa^Fpa, Aa, Aa^Fpa
Aa, Aa, Aa, Rb, Rb, Aa, Aa, Aa, Aa, Aa, Aa, Aa^Fpa, Aa^Fpa, Aa^Fpa, Aa^Fpa, Aa^Fpa, Aa, Aa^Fpa, Aa^Fpa, Aa^Fpa, Aa, Aa^Fpa, Aa^Fpa, Aa^Fpa, Aa^Fpa, Aa^Fpa, Aa, Aa, Aa, Aa, Aa, Aa^Fpa, Aa, Ha, Aa^Fpa, Ha, Aa^Fpa, Aa^Fpa, Ha, Ha, Aa^Fpa, Ha, Aa^Fpa, Ha, Ha, Aa^Fpa, Aa^Fpa
Aa, Aa, Aa, Aa^Voa, Rb, Aa, Aa, Aa, Aa, Aa, Aa, Aa, Aa, Aa^Fpa, Aa, Aa^Voa, Aa, Aa, Aa^Fpa, Aa^Fpa, Aa^Fpa, Aa^Fpa, Aa^Fpa, Aa^Fpa, Aa, Aa^Fpa, Aa^Fpa, Aa^Fpa, Ha, Aa, Aa, Aa^Fpa, Aa, Aa^Fpa, Aa^Fpa, Aa, Aa^Fpa, Aa, Aa, Ha, Ha, Ha, Ha, Aa^Fpa, Ha, Ha, Aa
Aa^Fpa, Aa, Aa, Aa, Aa, Rb, Cea, 1 Kea, Cea, Cea, Aa, Aa, Ha, Aa, Aa, Aa^Fpa, Aa^Fpa, Aa^Fpa, Aa^Fpa, Aa, Aa^Fpa, Aa^Fpa, Aa^Fpa, Aa^Fpa, Ha, Aa^Fpa, Aa^Fpa, Ha, Aa^Fpa, Ha, Ha, Aa^Fpa, Aa^Fpa, Aa, Aa^Fpa, Aa^Fpa, Aa^Fpa, Aa^Fpa, Aa^Fpa, Aa^Fpa, Aa, Ha, Aa^Fpa, Ha, Aa^Fpa, Ha, Aa
Aa, Aa^Fpa, Aa^Fpa, Aa, Aa, Rb, Cea, Cea, Cea, Aa, Aa, Aa, Ha, Ha, Ha, Ha, Aa, Aa^Fpa, Aa^Fpa, Aa^Fpa, Aa, Aa, Ha, Ha, Aa, Aa, Aa, Aa, Ha, Aa, Ha, Ha, Aa^Fpa, Aa^Fpa, Aa^Fpa, Aa^Voa, Aa^Fpa, Aa^Fpa, Aa, Aa, Aa, Aa, Aa^Fpa, Aa^Fpa, Aa^Fpa, Aa, Aa^Fpa
Aa, Aa^Fpa, Aa^Fpa, Aa, Aa, Aa, Aa, Aa, Aa, Rb, Aa, Aa, Aa, Aa, Ha, Ha, Ha, Aa^Fpa, Aa^Fpa, Aa, Aa^Fpa, Aa^Fpa, Ha, Aa^Fpa, Aa^Fpa, Aa^Fpa, Aa^Fpa, Aa^Fpa, Aa, Ha, Aa, Aa, Aa, Aa^Fpa, Aa, Aa^Fpa, Aa, Aa, Rb, Aa, Aa, Aa, Aa^Fpa, Aa, Aa^Fpa, Aa, Aa^Fpa
Aa, Aa^Fpa, Aa, Aa, Aa, Aa, Aa, Aa, Aa, Aa, Aa, Aa, Rb, Aa, Aa, Ha, Ha, Ha, Ha, Aa^Fpa, Aa^Fpa, Aa^Fpa, Aa^Fpa, Aa, Aa^Fpa, Aa, Aa^Fpa, Aa, Aa, Aa, Aa, Aa, Aa, Aa, Aa, Aa, Rb, Rb, Coa, Aa, Coa, Aa, Aa, Aa^Fpa, Aa^Voa, Aa^Fpa, Aa^Fpa
Aa, Aa^Fpa, Aa^Fpa, Aa^Fpa, Aa^Fpa, Aa, Aa, Aa, Aa^Fpa, Aa, Aa, Aa, Ha, Aa, Rb, Aa, Aa, Aa, Aa, Aa, Aa, Aa, Aa, Aa^Fpa, Aa, Aa^Fpa, Aa, Aa^Fpa, Aa^Fpa, Aa, Aa^Fpa, Aa^Fpa, Aa^Fpa, Aa, Aa, Aa, Rb, Aa, Coa, 2 Koa, Coa, Aa, Aa, Aa^Fpa, Aa, Aa^Fpa, Aa
Aa^Fpa, Ha, Ha, Ha, Ha, Aa^Fpa, Aa^Fpa, Aa, Aa, Aa^Fpa, Aa^Fpa, Ha, Aa, Aa, Aa, Rb, Aa, Aa, Aa, Aa, Aa^Voa, Rb, Rb, Aa^Voa, Koa, Aa, Ha, Aa, Ha, Aa, Aa, Aa, Aa, Aa, Aa, Rb, Rb, Coa, Rb, Coa, Coa, Aa, Aa^Fpa, Aa^Fpa, Aa^Fpa, Aa^Fpa, Aa
Ha, Ha, Aa^Fpa, Aa^Fpa, Ha, Aa, Aa, Aa^Fpa, Aa^Voa, Aa^Fpa, Aa, Ha, Ha, Aa, Aa^Voa, Aa, Aa, Rb, Rb, Aa, Aa, Aa, Aa, Ha, Coa, Ha, Ha^Fpa, Ha, Aa, Ha, Ha, Aa, Aa, Rb, Rb, Rb, Rb, Rb, Rb, Coa, Aa, Aa, Aa^Fpa, Aa^Fpa, Aa^Fpa, Aa, Aa
Ha, Aa, Ha, Aa, Aa, Ha, Aa, Aa, Aa, Aa, Aa, Ha, Ha, Aa, Aa, Aa, Ha^Fpa, Ha, Aa, Rb, Rb, Coa, Koa, Coa, Aa, Ha^Fpa, Ha, Ha^Fpa, Ha, Ha^Fpa, Aa, Aa, Rb, Rb, Aa, Rb, Aa, Aa, Aa, Aa, Aa^Fpa, Aa, Aa, Aa^Voa, Aa, Aa^Fpa, Aa^Fpa
Ha, Ha, Ha, Ha, Ha, Ha, Aa, Aa, Aa, Aa, Aa, Ha, Aa, Aa, Aa, Aa, Coa, Ha, Coa, Rb, Rb, Aa, Aa, Coa, Ha^Fpa, Aa^Fpa, Aa^Fpa, Aa, Aa, Aa, Aa, Aa, Rb, Rb, Aa, Aa, Aa^Fpa, Aa, Aa^Fpa, Aa^Fpa, Aa^Fpa, Aa^Fpa, Ha, Aa^Fpa, Aa^Fpa, Aa^Fpa, Aa^Fpa
Aa, Ha, Aa, Ha, Aa, Aa, Aa, Aa, Ai, Aa, Aa, Aa, Aa, Aa, Aa, Aa, Aa, Aa, Aa, Aa, Aa, Rb, Rb, Ha, Aa, Aa, Aa, Aa, Aa, Aa, Ai, Aa, Rb, Aa, Aa, Aa, Aa, Aa^Fpa, Ha, Aa, Ha, Ha, Aa, Ha, Aa, Aa^Fpa, Aa
Aa, Aa, Aa, Aa, Ai, Aa, Ai, Ai, Ai, Ai, Aa, Aa, Ai, Aa, Ai, Ai, Ai, Aa, Ai, Ai, Ai, Rb, Rb, Aa, Aa, Aa, Ai, Ai, Ai, Ai, Aa, Ai, Ai, Ai, Ai, Aa, Aa, Ha, Aa, Ha, Aa, Aa, Ai, Aa, Ai, Aa, Aa
Ai, Ai, Ai, Aa, Ai, Ai, Aa, Aa, Aa, Aa, Ai, Aa, Ai, Ai, Ai, Aa, Ai, Ai, Ai, Ai, Aa, Aa, Rb, Ai, Aa, Ai, Aa, Aa, Aa, Ai, Aa, Rb, Aa, Aa, Aa, Ai, Ai, Aa, Ai, Ai, Ai, Ai, Aa, Aa, Aa, Ai, Ai
Ai, Ai, Ai, Ai, Ai, Aa, Ai, Ai, Ai, Aa, Aa, Ai, Ai, Ai, Ai, Aa, Ai, Ai, Aa, Ai, Ai, Aa, Rb, Ai, Aa, Aa, Ai, Ai, Aa, Aa, Aa, Rb, Ai, Ai, Ai, Aa, Aa, Ai, Ai, Aa^Voa, Aa, Aa, Ai, Ai, Ai, Aa, Ai
Aa, Ai, Ai, Ai, Aa, Aa, Aa, Ai, Ai, Ai, Aa, Ai, Ai, Ai, Ai, Aa, Aa, Aa, Aa, Ai, Ai, Aa, Aa, Rb, Ai, Ai, Aa, Aa, Aa, Aa, Aa, Rb, Rb, Aa, Aa, Ai, Ai, Aa, Aa, Ai, Ai, Ai, Aa, Ai, Ai, Ai, Ai
Aa, Aa, Aa, Aa, Ha, Ha, Aa, Aa, Aa, Aa, Aa, Aa, Aa, Ai, Aa^Voa, Aa, Aa^Fpa, Aa, Aa, Aa, Aa, Ai, Ai, Rb, Rb, Aa, Koa, Aa, Ha, Ha, Aa, Aa, Rb, Aa, Ha, Aa, Aa, Ai, Ha, Aa, Aa, Aa, Aa^Fpa, Aa^Fpa, Aa^Fpa, Ai, Aa
Aa, Aa, Ha, Ha, Aa, Aa, Aa, Aa, Aa, Aa, Aa, Ha, Ha, Aa, Aa, Aa, Aa, Aa, Aa, Aa, Coa, Coa, Koa, Aa, Rb, Aa, Ha, Ha, Ha^Fpa, Ha, Ha, Rb, Aa, Aa, Ha, Ha, Ha, Ha, Ha, Aa^Fpa, Aa^Fpa, Aa^Fpa, Aa^Fpa, Aa^Fpa, Aa^Fpa, Aa^Fpa, Aa
Aa, Aa^Fpa, Aa^Fpa, Ha, Ha, Ha, Ha, Ha, Ha, Ha, Ha^Fpa, Ha^Fpa, Ha^Fpa, Aa, Ha^Fpa, Aa, Ha^Fpa, Aa^Fpa, Aa^Fpa, Aa, Aa, Coa, Rb, Rb, Rb, Rb, Coa, Ha, Ha^Fpa, Ha^Fpa, Aa, Rb, Rb, Ha, Ha, Aa, Aa, Aa, Ha, Aa^Fpa, Aa^Fpa, Ha, Ha, Aa, Aa, Aa^Fpa, Aa
Aa, Aa^Fpa, Ha, Aa^Fpa, Aa, Aa, Aa, Aa, Ha, Ha^Fpa, Ha, Ha, Aa, Aa^Fpa, Ha, Ha, Aa, Ha, Aa, Aa, Rb, Rb, Aa, Coa, Aa, Rb, Aa, Ha, Aa^Fpa, Aa^Voa, Aa, Rb, Rb, Aa, Aa, Aa^Voa, Aa, Aa^Fpa, Aa, Ha, Ha, Aa^Fpa, Aa^Fpa, Ha, Aa^Fpa, Aa^Fpa, Aa
Aa, Aa^Fpa, Ha, Ha, Aa^Fpa, Ha, Ha, Aa, Aa, Ha, Aa, Ha, Aa, Aa, Aa, Aa^Voa, Ha, Aa, Aa, Rb, Ha, Ha^Fpa, Ha^Fpa, Aa, Ha, Rb, Rb, Aa, Aa, Aa, Coa, Coa, Coa, Rb, Aa, Aa, Aa^Fpa, Aa, Aa^Fpa, Aa^Fpa, Aa^Fpa, Aa^Fpa, Ha, Ha, Aa, Aa^Fpa, Aa
Aa^Fpa, Ha, Aa^Fpa, Ha, Ha, Aa^Fpa, Ha, Aa, Aa^Voa, Aa^Fpa, Aa, Aa, Aa, Aa, Aa, Aa, Aa, Aa, Rb, Rb, Aa, Aa^Fpa, Aa, Ha^Fpa, Ha, Aa, Aa, Rb, Rb, Aa, Coa, 3 Koa, Coa, Aa, Aa, Aa^Fpa, Aa, Aa, Aa^Fpa, Aa, Aa^Fpa, Aa^Fpa, Aa^Fpa, Aa^Fpa, Aa^Fpa, Aa^Fpa, Aa
Ha, Ha, Ha, Aa^Fpa, Aa^Fpa, Ha, Aa^Fpa, Aa, Aa^Fpa, Aa^Fpa, Aa, Coa, Rb, Aa, Rb, Aa, Aa^Fpa, Koa, Rb, Aa, Rb, Rb, Rb, Rb, Rb, Aa, Rb, Rb, Rb, Aa, Rb, Coa, Aa, Aa, Rb, Aa, Aa, Aa^Fpa, Aa, Aa^Fpa, Aa^Voa, Aa, Aa^Fpa, Aa, Aa^Fpa, Aa, Aa
Aa, Aa^Fpa, Aa^Fpa, Ha, Ha, Ha, Aa, Aa, Aa^Fpa, Aa, Coa, Coa, 4 Koa, Coa, Coa, Aa, Aa, Aa, Rb, Rb, Koa, Rb, Aa, Aa, Aa, Rb, Aa^Voa, Rb, Aa, Aa, Aa, Rb, Rb, Aa, Rb, Aa, Aa, Aa, Aa, Aa^Fpa, Aa, Aa^Fpa, Aa^Fpa, Aa^Fpa, Aa, Aa^Fpa, Aa^Fpa
Aa, Aa^Fpa, Aa^Fpa, Aa^Fpa, Aa, Aa^Fpa, Aa^Fpa, Aa^Fpa, Aa^Fpa, Aa, Coa, Aa, Coa, Coa, Coa, Rb, Rb, Rb, Aa^Fpa, Aa^Fpa, Aa^Fpa, Aa^Fpa, Aa, Aa, Aa, Aa, Aa, Aa, Aa^Fpa, Aa^Fpa, Aa, Aa, Aa, Rb, Aa, Aa, Aa, Aa, Aa, Aa^Fpa, Aa^Fpa, Aa^Fpa, Aa^Fpa, Aa^Fpa, Aa^Fpa, Aa^Fpa, Aa
Aa^Fpa, Aa^Fpa, Aa^Fpa, Aa^Fpa, Aa, Aa, Aa^Fpa, Aa^Fpa, Aa^Fpa, Aa, Aa, Aa, Coa, Coa, Rb, Rb, Aa, Aa^Fpa, Aa^Fpa, Aa^Voa, Aa^Fpa, Aa^Fpa, Aa, Aa, Aa, Aa, Aa^Fpa, Aa^Fpa, Aa, Aa^Fpa, Aa^Fpa, Aa, Aa^Voa, Aa^Fpa, Aa, Aa, Rb, Aa, Aa, Ha, Ha, Ha, Aa, Aa, Aa, Aa, Aa
Aa^Fpa, Aa, Aa^Fpa, Aa, Ha, Aa, Ha, Aa^Fpa, Aa^Fpa, Aa^Fpa, Aa^Voa, Aa, Aa, Aa, Aa^Fpa, Aa, Aa^Fpa, Aa^Fpa, Aa^Fpa, Aa^Fpa, Aa^Fpa, Aa, Aa^Fpa, Aa, Aa^Voa, Aa^Fpa, Aa^Fpa, Aa, Aa, Aa, Aa^Fpa, Aa, Aa, Aa, Aa, Aa, Aa, Rb, Rb, Aa, Aa^Fpa, Aa^Fpa, Aa^Fpa, Aa^Fpa, Ha, Ha, Aa
Aa^Fpa, Aa, Aa^Fpa, Aa, Ha, Ha, Aa^Fpa, Ha^Fpa, Aa^Fpa, Aa^Fpa, Ha, Aa^Fpa, Aa^Fpa, Aa, Aa^Fpa, Aa, Aa, Aa^Fpa, Aa, Aa, Aa, Aa^Fpa, Aa^Fpa, Aa^Fpa, Aa, Aa^Fpa, Aa, Aa, Aa, Aa, Aa^Fpa, Aa^Fpa, Aa, Aa, Aa^Fpa, Aa, Aa, Aa, Rb, Aa, Aa, Aa, Aa, Aa^Fpa, Aa, Aa^Fpa, Aa
Aa^Fpa, Aa, Ha, Ha, Aa, Ha, Aa^Fpa, Aa, Ha^Fpa, Ha, Aa^Fpa, Ha, Aa, Aa, Ha, Aa, Aa, Aa^Fpa, Aa^Fpa, Aa, Aa^Fpa, Aa^Fpa, Aa, Ha, Ha, Ha, Ha, Aa^Fpa, Aa^Fpa, Aa, Aa^Fpa, Aa^Fpa, Aa^Fpa, Aa^Fpa, Aa^Fpa, Aa, Aa, Aa, Aa, Aa, Aa, Aa, Aa, Aa, Aa, Aa^Fpa, Aa
Aa^Fpa, Ha, Ha, Aa, Ha, Ha, Ha^Fpa, Ha^Fpa, Ha, Ha, Ha^Fpa, Aa^Fpa, Ha, Aa^Fpa, Ha^Fpa, Ha, Aa, Aa^Fpa, Aa^Fpa, Aa^Fpa, Aa, Aa^Fpa, Aa^Fpa, Ha, Aa, Aa, Aa, Ha, Ha, Aa^Fpa, Aa^Fpa, Aa^Fpa, Aa, Ha, Ha, Aa, Aa, Aa, Aa, Ha, Aa, Rb, Rb, Aa, Aa, Aa^Fpa, Aa
Aa^Fpa, Ha, Ha, Ha^Fpa, Ha^Fpa, Ha^Fpa, Ha^Fpa, Ha, Ha^Fpa, Ha, Ha, Ha^Fpa, Ha, Ha, Ha^Fpa, Aa, Aa^Fpa, Aa^Fpa, Aa^Fpa, Aa^Fpa, Aa, Ha, Aa, Aa^Fpa, Aa^Fpa, Aa^Fpa, Aa^Fpa, Aa, Aa^Fpa, Ha, Ha, Aa, Aa, Aa^Fpa, Aa, Ha, Ha, Ha, Ha, Ha, Aa, Aa, Aa, Rb, Rb, Aa, Aa
Aa^Fpa, Aa^Fpa, Aa^Fpa, Ha, Aa^Fpa, Ha, Ha, Aa^Fpa, Aa^Fpa, Aa, Ha, Ha, Aa, Ha, Aa^Fpa, Ha, Aa, Aa, Aa^Fpa, Aa^Fpa, Aa^Fpa, Ha, Ha, Aa^Fpa, Ha, Ha, Aa, Aa, Aa^Fpa, Ha, Aa, Aa, Aa, Aa^Fpa, Aa, Aa^Fpa, Ha, Ha, Aa, Aa, Ha, Aa, Aa, Rb, Rb, Aa, Aa
Aa^Fpa, Aa, Aa^Fpa, Ha, Aa, Ha, Ha, Ha^Fpa, Aa^Fpa, Aa, Ha^Fpa, Ha, Ha^Fpa, Ha, Aa, Aa^Fpa, Aa, Aa, Aa^Fpa, Aa, Aa, Ha, Ha, Aa, Ha, Aa^Fpa, Ha, Ha, Ha, Ha, Aa^Fpa, Aa^Fpa, Aa, Aa, Aa, Aa, Ha, Ha, Aa, Aa, Ha, Ha, Aa^Fpa, Aa, Aa, Rb, Aa
Aa^Fpa, Aa, Aa^Fpa, Aa^Fpa, Aa^Fpa, Aa, Aa^Fpa, Ha, Ha, Aa^Fpa, Aa^Fpa, Aa^Fpa, Ha, Ha, Ha^Fpa, Ha, Aa^Fpa, Aa, Aa^Fpa, Aa^Fpa, Aa^Fpa, Aa^Fpa, Aa, Aa, Aa^Fpa, Ha, Aa^Fpa, Ha, Aa^Fpa, Aa^Fpa, Aa^Fpa, Aa^Fpa, Aa^Fpa, Aa^Fpa, Aa, Aa^Fpa, Aa^Fpa, Aa^Fpa, Aa^Fpa, Aa^Fpa, Aa^Fpa, Aa^Fpa, Aa, Aa, Aa, Rb, Rb
Aa^Fpa, Aa^Fpa, Aa, Aa^Fpa, Ha, Ha, Ha, Aa, Ha, Ha, Aa^Fpa, Aa, Ha, Aa, Ha, Ha, Aa, Aa^Fpa, Aa^Fpa, Aa^Fpa, Aa^Fpa, Aa^Fpa, Aa^Fpa, Aa^Fpa, Aa^Fpa, Aa^Fpa, Aa^Fpa, Aa, Aa, Aa, Aa, Aa^Fpa, Aa^Fpa, Aa, Aa^Fpa, Aa, Aa^Fpa, Aa, Aa^Fpa, Aa, Aa^Fpa, Aa^Fpa, Aa^Fpa, Aa, Aa^Fpa, Aa, Aa
Aa^Fpa, Aa, Aa, Aa^Fpa, Aa^Fpa, Aa^Fpa, Aa^Fpa, Ha, Aa^Fpa, Ha, Aa, Ha, Aa^Fpa, Ha, Aa, Aa, Aa, Aa, Aa, Aa, Aa, Aa, Aa, Aa, Aa, Aa, Aa, Aa, Aa, Aa, Aa, Aa, Aa, Aa^Fpa, Aa, Aa^Fpa, Aa, Aa^Fpa, Aa, Aa, Aa, Aa, Aa, Aa^Fpa, Aa^Fpa, Aa, Aa
