border_size=1
usage=map

Aa, Aa, Aa^Fdw, Aa, Aa^Fma, Aa^Fda, Aa^Fpa, Aa, Ha, Ms^Xm, Ms, Ms^Xm, Ms^Xm, Ms^Xm, Ms^Xm, Ms^Xm, Ms, Ms, Ha, Ha, Ha^Fpa, Ha, Ms, Aa, Ha, Ha, Ha, Ha^Fda, Ha^Fda, Ha, Ms, Gll, Ms^Xm, Ms^Xm, Ms^Xm, Ms^Xm, Ms^Xm, Aa, Ms^Xm, Ms^Xm, Ms^Xm, Ms^Xm
Aa^Fpa, Aa^Fda, Aa^Fma, Aa^Fda, Gll^Fmw, Aa^Fda, Gll, Aa^Fda, Ha^Fma, Ms, Ms, Ms^Xm, Ms, Ms^Xm, Ms^Xm, Ms^Xm, Ms, Ms, Ms, Ha^Fpa, Ha^Fma, Ha^Fpa, Ms, Ms, Ai, Ha^Fpa, Ha^Fda, Ha^Fpa, Ha^Fda, Ha, Ms, Ms, Ms, Ms^Xm, Ms^Xm, Ms^Xm, Ms^Xm, Ms^Xm, Cud, Ms^Xm, Ms^Xm, Ms^Xm
Gll^Fmw, Gll^Fmw, Gll^Fdw, Gll^Fmw, Cha, Cha, Cha, Gll, Ha^Voa, Ha, Ha, Ms, Ha, Ms, Ms, Ms, Ms, Ms, Ms, Ha, Ha^Fpa, Ha^Fpa, Ha, Ms, Ms, Ai, Ha^Fma, Ha^Fpa, Ha^Fma, Ha^Fpa, Ha, Ms, Ms, Ms^Xm, Ms, Ms^Xm, Cud, Cud, 4 Kud, Cud, Ms^Xm, Ms^Xm
Gll, Gll^Fmw, Cha, Cha, 3 Kha, Cha, Cha, Gll, Gll^Fmw, Ha^Fma, Ha^Fma, Ha^Fpa, Ha^Fpa, Ai, Ha^Fda, Ha, Ha, Ha, Ms, Ha, Ha^Fpa, Ha^Fma, Ha, Ms, Ai, Ai, Ha^Fpa, Ha^Fpa, Ha^Fma, Ha^Fda, Ha, Ms, Ha, Ms, Ha^Fma, Ha, Cud, Cud, Cud, Cud, Ms, Ms
Rb, Rb^Edt, Cha, Cha, Cha, Cha, Gll, Gll^Fmw, Gll^Fmw, Ha, Ha, Ha, Gll, Ha, Ha^Fma, Ha^Fda, Ha^Fma, Ha^Fpa, Ha, Ms, Ha, Ha^Fpa, Ai, Ai, Ai, Ha, Ha, Ha^Fpa, Ha, Ha, Aa, Ha^Fpa, Ha, Ha^Fma, Hhd^Fdw, Hhd^Fdw, Hhd, Cud, Cud, Cud, Ha^Fma, Ms
Rb, Rb^Edt, Rb, Cha, Gll, Gll^Edt, Gll^Edt, Gll^Edt, Gll^Edt, Gll, Aa, Gll, Gll, Gll, Gll, Ha^Voa, Ha, Ha^Fma, Ha^Fma, Ha, Gll, Ai, Ai, Ai, Gll, Gll, Aa, Ha, Aa, Aa, Aa^Edt, Aa^Voa, Rb, Ha^Fma, Rb^Fdw, Hhd, Rb, Hhd^Fdw, Hhd, Ha, Ha, Ms
Gll^Fmw, Rb, Rb, Rb, Rb, Aa^Voa, Aa, Gll^Edt, Aa, Aa, Aa^Fpa, Aa, Aa, Gll, Aa, Gll, Gll, Gll, Gll, Ha, Gll, Aa, Gll, Aa, Gll, Gll, Aa, Gll, Gll^Fdw, Gll, Gll^Edt, Gll, Rb, Hhd^Fdw, Hhd, Hhd, Rb, Hhd^Fdw, Hhd^Fdw, Hhd^Fdw, Ha, Ha^Fma
Gll, Gll^Fmw, Gll, Rb, Rb, Rb, Aa, Aa, Aa^Fda, Aa^Fma, Hhd, Aa, Gll^Es, Aa, Aa, Aa, Gll^Fdw, Gll, Aa, Aa, Aa, Aa, Gll, Gll^Es, Gll, Gll, Gll, Gll^Fdw, Gll^Fmw, Gll^Fmw, Gll, Aa, Aa, Rb, Gll, Rb, Rb, Rb, Aa, Ha^Voa, Rb, Rb
Ms^Xm, Ms, Ha, Rb, Gll^Edt, Rb, Rb, Rb, Rb, Hhd, Gll, Gll, Gll, Aa, Gll, Aa^Fdw, Gll^Fdw, Gll^Fdw, Gll, Gll, Ha, Ha, Aa, Aa, Ha, Gll, Gll^Es, Gll^Vo, Gll, Gll, Ha, Gll, Aa, Aa, Gll, Rb, Aa, Rb, Rb, Aa, Rb, Rb
Ms^Xm, Ms, Ha, Ha^Fda, Aa^Fma, Gll, Gll, Rb, Rb, Rb, Rb, Rb, Rb, Gll, Gll, Gll, Gll^Edt, Gll, Gll, Gll, Gll, Aa, Aa, Aa, Ha, Ha, Gll, Gll, Aa^Fma, Aa^Fpa, Rb, Gll, Gll, Gll, Rb, Rb, Rb, Rb, Aa, Rb, Ms, Ms
Ms^Xm, Ms, Ms, Ha^Fda, Aa^Voa, Aa^Fma, Gll, Gll, Gll, Rb, Rb, Rb, Rb, Rb, Rb, Gll, Gll, Aa, Aa, Aa^Fpa, Aa^Fpa, Aa^Fma, Aa^Fpa, Aa, Gll, Gll, Rb, Aa, Rb, Aa, Rb, Rb, Rb, Rb, Aa, Aa, Ha^Fma, Ha^Voa, Ms, Ms, Ms, Ms
Ms^Xm, Ms, Ha, Ha, Aa^Fma, Gll, Gll^Fdw, Hhd^Fdw, Gll, Gll, Aa, Aa^Voa, Aa, Rb, Rb, Rb^Edt, Rb, Gll, Aa, Aa, Aa, Aa^Fma, Coa, Gll, Rb, Rb^Edt, Rb, Rb, Gll, Rb, Gll, Rb, Gll^Fmw, Rb, Ha^Fpa, Ha^Fpa, Ms, Ha, Ms, Ms, Ms^Xm, Ms^Xm
Ms^Xm, Ms^Xm, Ha, Ha, Aa, Gll, Gll, Hhd^Fdw, Gll, Aa, Aa, Aa^Fpa, Aa^Fpa, Aa^Fpa, Aa, Rb, Rb, Rb, Rb, Aa^Voa, Gll, Gll, Gll, Coa, Rb, Rb^Edt, Rb, Gll, Gll^Fdw, Gll^Fdw, Gll^Fdw, Aa^Fmw, Gll^Fmw, Aa, Ms, Ms, Ms, Ms, Ms, Ha, Ms^Xm, Ms^Xm
Ms^Xm, Ms, Ha, Gll, Gll, Gll, Aa, Aa, Gll, Aa, Hhd, Aa, Gll, Aa, Coa, Coa, Rb, Rb, Rb, Rb, Rb, Rb, Rb, Rb, Rb, Rb^Edt, Rb, Gll, Gll, Aa, Aa, Aa, Aa, Ha, Ms, Ms, Ha, Ha, Ai, Ai, Ms^Xm, Ms^Xm
Ms^Xm, Ha, Ha^Fma, Aa, Aa, Aa, Aa, Gll, Gll, Hhd, Aa, Gll, Gll^Edt, Gll^Edt, Gll, Rb, Rb, Rb, Coa, Coa, Coa, Rb, Rb, Rb, Rb, Rb, Rb, Aa^Voa, Aa, Aa^Fpa, Aa^Fpa, Gll^Es, Gll, Ha^Fpa, Ha^Fpa, Ha^Fpa, Ha^Fma, Ha^Fma, Ha, Ms^Xm, Ms^Xm, Ms^Xm
Ms^Xm, Ha^Fma, Ha^Fma, Aa, Aa, Aa^Voa, Aa^Fma, Aa^Fpa, Aa, Aa, Aa, Gll, Gll, Gll, Rb, Rb, Coa, Coa, Aa^Voa, Aa, Co, Coa, Coa, Coa, Coa, Rb, Rb, Rb, Gll, Aa^Fpa, Aa^Fda, Gll, Aa, Ha, Ha^Fpa, Ha^Fma, Ms, Ha^Fma, Ha, Ms^Xm, Ms^Xm, Ms^Xm
Ha, Ha, Ai, Aa, Gll, Gll, Aa^Fma, Aa^Fma, Gll, Gll, Gll, Gll, Aa, Aa^Voa, Rb, Rb, Coa, Rb, Coa, Coa, Coa, Rb, Aa, Rb, Co, Coa, Rb, Rb, Aa, Aa, Aa^Fda, Aa^Fpa, Gll, Ha, Ms, Ha, Ms, Ha^Voa, Ms, Ms^Xm, Ms^Xm, Ms^Xm
Ai, Ai, Ai, Aa, Gll, Aa^Fda, Aa^Fpa, Gll, Aa, Gll, Aa, Aa, Aa^Fpa, Aa, Aa, Rb, Coa, Aa, Coa, 2 Koa, Coa, Aa^Voa, Aa, Koa, Co, Coa, Rb, Rb, Aa, Aa^Fda, Aa^Fda, Aa, Gll, Ha, Ms, Ms, Ms, Ms, Ms, Ms, Ms, Ms^Xm
Ai, Ai, Aa, Aa, Aa, Gll, Aa, Aa, Aa, Gll, Aa, Aa^Fpa, Aa^Fma, Aa, Rb, Rb, Coa, Aa^Voa, Aa, Coa, Co, Rb, Coa, Rb, Coa, Coa, Rb, Rb, Coa, Aa^Fda, Gll, Gll^Edt, Aa, Aa, Ha, Ha, Ha, Ms, Ms, Ms, Ms, Ms
Ai, Aa, Gll^Fma, Gll^Fma, Gll^Fpa, Gll, Gll, Gll, Gll^Edt, Hhd, Aa, Aa^Fpa, Gll, Aa, Rb, Rb, Rb, Coa, Coa, Rb, Coa, Coa, Rb, Coa, Rb, Rb, Rb, Rb, Coa, Gll, Aa^Fda, Gll^Edt, Aa^Fpa, Aa^Fpa, Aa, Ha^Fda, Ha^Fma, Ha^Fpa, Ha^Fpa, Ha, Ha^Fda, Ha
Ha, Ha^Fpa, Ha^Fma, Gll^Fma, Gll^Fma, Gll, Gll, Aa, Ha, Gll, Gll, Gll^Es, Gll, Coa, Coa, Rb, Rb, Rb, Rb, Coa, Rb, Rb, Rb, Rb, Rb, Rb, Gll, Gll, Aa, Aa, Aa^Fma, Aa^Fma, Aa^Fpa, Aa, Gll, Ha^Fda, Ha^Fda, Ha^Fda, Ha^Fma, Ha^Fpa, Ai, Ai
Ms, Ha^Fpa, Ha, Ha^Fma, Aa, Gll^Fpa, Aa^Fpa, Aa, Ha, Ha, Gll, Aa, Aa, Gll, Aa, Aa, Gll^Edt, Rb, Aa, Rb, Rb, Rb, Hhd, Gll, Gll, Gll, Aa^Voa, Gll, Gll, Aa, Gll, Gll, Gll, Gll, Ms, Ms, Ms, Ms, Ha^Fpa, Aa^Fda, Ai, Ai
Ms, Ms, Ha, Ha^Fpa, Ha^Fpa, Aa^Fma, Gll^Fpa, Aa^Fpa, Aa, Ha, Gll, Gll^Fdw, Aa^Fdw, Gll^Fmw, Gll^Fmw, Aa, Gll, Gll, Aa^Voa, Aa, Gll, Rb, Rb, Hhd, Gll, Aa, Aa^Fma, Aa^Fda, Aa^Fma, Gll, Gll, Gll, Gll, Aa, Aa, Ms, Ha^Fma, Ha^Fma, Ms, Ms, Ms, Ai
Ms, Ms, Ms, Ha, Ha, Ha, Gll, Gll^Es, Gll, Aa, Gll, Gll^Fdw, Gll, Gll^Fmw, Gll^Fmw, Gll^Fmw, Gll, Aa, Gll, Gll, Gll, Rb, Rb, Gll, Gll^Fmw, Gll^Fmw, Aa^Fdw, Aa^Fpa, Gll, Gll, Aa, Gll, Aa^Voa, Aa, Aa^Fpa, Ha^Fpa, Ha, Ha, Ms, Ms, Ms^Xm, Ms^Xm
Ms, Ms, Ms, Ms, Ha^Fda, Ha, Ha^Voa, Gll, Aa, Gll, Gll^Fmw, Gll, Gll, Gll, Aa, Aa, Gll, Gll, Gll^Edt, Gll, Aa, Aa, Rb, Rb, Rb, Gll^Fdw, Gll, Aa, Gll, Gll, Gll, Gll, Gll, Aa, Ms, Ms, Aa, Ms, Ms, Ms^Xm, Ms^Xm, Ms^Xm
Ms, Ms, Ha, Ha^Fda, Ha^Fma, Ha^Fma, Ai, Aa, Ai, Gll, Aa, Gll^Fdw, Gll, Gll, Aa^Fda, Aa, Aa, Gll^Es, Gll, Aa, Ha, Aa, Aa^Voa, Rb, Rb, Rb, Rb, Gll, Gll^Fdw, Aa^Fda, Aa^Fma, Aa, Aa, Gll, Gll, Ms, Ms, Ms, Ms, Ms^Xm, Ms^Xm, Ms^Xm
Ai, Ha^Fma, Ha^Fda, Ha, Aa^Fma, Aa^Fpa, Ai, Ai, Gll^Fdw, Aa^Fdw, Aa^Fmw, Gll^Fdw, Aa, Gll^Es, Gll, Aa, Aa, Aa^Fpa, Aa^Fpa, Aa^Fpa, Ha, Aa, Aa^Fda, Gll, Aa, Rb, Rb, Rb, Rb, Aa^Fda, Aa^Fma, Aa^Fma, Aa^Fda, Gll, Ha, Ha^Fpa, Ha^Fpa, Ms, Ms, Ha, Ha, Ms^Xm
Ha, Ai, Ai, Aa, Ai, Ai, Ai, Ai, Gll^Fdw, Gll^Fmw, Aa, Gll, Gll, Aa, Ai, Ai, Ai, Ai, Ai, Gll, Gll, Aa^Fda, Gll, Aa, Aa, Aa, Gll, Rb, Rb, Aa, Rb, Aa, Gll, Aa, Gll^Es, Ha, Ha^Fda, Ha, Ha, Ha, Ms, Ha
Ha, Ha^Fma, Ha^Fda, Ai, Gll, Aa^Fda, Aa, Ai, Aa, Gll^Fdw, Gll, Gll, Aa^Fpa, Aa, Ai, Ai, Ai, Ai, Ai, Gll, Gll, Gll, Gll, Gll, Aa, Gll, Gll^Es, Gll, Rb, Rb, Rb, Gll, Gll^Edt, Gll, Gll, Aa, Aa, Ha^Fda, Ha, Ms, Ms, Ms
Ha, Ha^Fda, Ha, Gll, Aa, Gll, Gll, Ai, Gll, Gll, Gll, Aa^Fpa, Aa, Ai, Ai, Ai, Ai, Ai, Aa^Fma, Aa, Aa^Fda, Gll, Aa, Gll, Ha, Gll, Gll, Gll, Aa^Fma, Gll, Aa^Voa, Rb, Rb, Rb, Rb, Rb^Edt, Rb, Ha, Ms, Ms, Ms, Ms
Ms, Ms, Ms, Ha^Fda, Ha^Fpa, Gll, Ms, Gll, Aa^Fpa, Gll, Gll, Gll, Ai, Ai, Aa^Fda, Aa, Ha^Voa, Aa^Fpa, Aa, Aa^Fpa, Aa^Fma, Aa^Fda, Aa^Fda, Ha^Fpa, Ha^Fma, Ha, Ha, Aa^Fma, Aa^Fpa, Aa^Fda, Aa, Gll, Rb, Rb, Ce, Rb, Rb, Ha, Ha, Ms, Ms, Ms
Ms, Ms, Ms, Ha^Fma, Ha^Fpa, Ha, Ms, Aa^Fpa, Aa^Fma, Aa^Fda, Aa^Fda, Aa^Fda, Ai, Aa^Fda, Aa, Aa, Ha, Ha^Fpa, Ha^Fpa, Ha, Ha, Aa, Ha, Ha^Fma, Ha^Fpa, Ha, Ai, Ai, Ai, Aa^Fma, Aa^Fma, Rb, Rb, Ce, Ce, Ce, Ce, Rb, Ha, Ha^Fpa, Ha^Fpa, Ms
Ms, Ms, Ha, Ha^Fma, Ha^Fma, Ms, Aa, Aa^Fma, Aa^Fpa, Aa, Ai, Ai, Aa^Fma, Aa^Fda, Ha^Fma, Ha^Fma, Ha, Ha^Fma, Ha^Fpa, Ha^Fpa, Ha^Fpa, Ha^Fpa, Ha^Fpa, Ha^Fpa, Ha, Ha^Fpa, Ai, Ai, Ai, Aa^Fma, Aa, Rb, Rb, Ce, Ce, 1 Ke, Ce, Rb, Rb, Aa, Ha^Fpa, Ha^Fpa
Ms^Xm, Ms, Ha, Ha, Ms, Ha^Fpa, Ha^Fpa, Aa^Fma, Aa^Fda, Aa^Fma, Ai, Ai, Ha, Ha^Fda, Ha, Ha, Ms, Ha, Ms, Ha, Ms, Ha, Ms, Ha, Ha, Ha^Fpa, Ha, Ai, Ha^Fda, Aa, Gll, Gll^Edt, Rb, Rb, Rb, Ce, Rb, Rb, Rb, Aa^Voa, Aa, Ha
Ms^Xm, Ms^Xm, Ms, Ms, Ms, Ms, Ms, Ha, Aa^Fma, Aa^Fma, Ai, Ha, Ha, Ha, Ms, Ms, Ms, Ms, Ms^Xm, Ms, Ms, Ms, Ms^Xm, Ms, Ms, Ha, Ms, Ai, Ha, Ha^Fda, Ha^Voa, Gll, Gll, Rb^Edt, Rb, Rb, Rb, Rb, Rb, Rb, Aa, Aa
Ms^Xm, Ms^Xm, Ms^Xm, Ms, Ms, Ms, Ms, Aa^Fma, Aa^Fpa, Aa^Fpa, Ai, Ha, Ha, Ms, Ms, Ms, Ms^Xm, Ms^Xm, Ms^Xm, Ms^Xm, Ms^Xm, Ms^Xm, Ms^Xm, Ms^Xm, Ms^Xm, Ms, Ms, Ms^Xm, Ms^Xm, Ha^Fda, Ha, Gll, Aa^Fpa, Rb, Aa^Fda, Rb, Aa^Fda, Aa, Aa, Rb, Rb, Rb
Ms^Xm, Ms^Xm, Ms^Xm, Ms^Xm, Ms^Xm, Ms, Aa, Aa^Fpa, Aa, Ai, Aa, Ai, Ms^Xm, Ms, Ms^Xm, Ms^Xm, Ms^Xm, Ms^Xm, Ms^Xm, Ms^Xm, Ms^Xm, Ms^Xm, Ms^Xm, Ms^Xm, Ms^Xm, Ms^Xm, Ms^Xm, Ms, Ms^Xm, Ms, Aa, Ha, Ha, Ha^Fpa, Ha^Fpa, Ha^Fpa, Ha^Fpa, Ha, Aa, Rb, Rb, Rb
