border_size=1
usage=map

Xu, Xu, Xu, Xu, Xu, Xu, Qxu, Qxu, Qxu, Xu, Xu, Xu, Xu, Xu, Xu, Xu, Xu, Xu, Xu, Xu, Xu, Xu, Wwg, Wwf, Wwg, Wwf, Uh, Xu, Xu, Xu, Xu, Xu, Xu, Xu, Xu, Xu, Xu, Xu, Xu, Xu, Xu, Xu, Xu, Xu, Xu, Xu, Xu, Xu, Xu, Xu, Xu, Xu
Xu, Xu, Xu, Xu, Qxu, Qxu, Urb, Urb, Urb, Qxu, Qxu, Xu, Xu, Xu, Xu, Xu, Xu, Xu, Xu, Xu, Xu, Xu, Wwf, Wwf, Wwg, Wwg, Wwf, Uh, Xu, Xu, Xu, Xu, Xu, Xu, Xu, Xu, Xu, Xu, Xu, Xu, Xu, Xu, Xu, Xu, Xu, Xu, Xu, Xu, Xu, Xu, Xu, Xu
Xu, Xu, Xu, Xu, Qxu, Urb, Urb, Urb, Urb, Urb, Qxu, Qxu, Uu, Xu, Xu, Xu, Xu, Xu, Xu, Xu, Xu, Xu, Uu^Uf, Wwf, Wwf, Wwf, Wwf, Uu, Uh, Xu, Xu, Xu, Xu, Xu, Xu, Xu, Xu, Xu, Xu, Xu, Xu, Xu, Xu, Xu, Xu, Xu, Xu, Xu, Xu, Xu, Xu, Xu
Xu, Xu, Xu, Xu, Qxu, Urb, Urb, 5 Urb, Urb, Urb, Xu, Qxu, Uu, Uh, Xu, Xu, Uh^Uf, Xu, Xu, Xu, Xu, Xu, Xu, Wwf, Wwf, Wwg, Wwg, Wwf, Uu, Xu, Xu, Xu, Xu, Xu, Xu, Xu, Xu, Xu, Xu, Xu, Xu, Xu, Xu, Xu, Xu, Xu, Xu, Xu, Xu, Xu, Xu, Xu
Xu, Xu, Xu, Xu, Qxu, Urb, Urb, Urb, Urb, Urb, Qxu, Uu, Uh, Uh^Uf, Xu, Qxu, Uu, Uu, Uh^Uf, Xu, Xu, Xu, Xu, Wwg, Wwf, Uu, Xu, Wwf, Wwf, Uh, Uh^Uf, Xu, Xu, Xu, Xu, Xu, Xu, Xu, Xu, Xu, Xu, Xu, Xu, Xu, Xu, Xu, Xu, Xu, Xu, Xu, Xu, Xu
Xu, Xu, Xu, Xu, Xu, Qxu, Qxu, Urb, Qxu, Qxu, Xu, Xu, Xu, Uh^Uf, Xu, Qxu, Qxu, Qxu, Qxu, Uh^Uf, Xu, Xu, Wwf, Uu, Wwf, Wwf, Wwg, Wwf, Wwf, Uh, Uh, Xu, Xu, Xu, Xu, Xu, Xu, Xu, Xu, Xu, Xu, Xu, Xu, Xu, Xu, Xu, Xu, Xu, Xu, Xu, Xu, Xu
Xu, Xu, Xu, Xu, Xu, Xu, Qxu, Urb, Qxu, Qxu, Qxu, Xu, Uh, Xu, Uh^Uf, Xu, Xu, Qxu, Xu, Uh, Xu, Wwf, Xu, Wwf, Wwf, Wwg, Wwg, Wwf, Wwf, Uu, Xu, Xu, Xu, Xu, Xu, Xu, Xu, Xu, Xu, Xu, Xu, Xu, Xu, Xu, Xu, Xu, Xu, Xu, Xu, Xu, Xu, Xu
Xu, Xu, Xu, Xu, Uh, Xu, Qxu, Urb, Urb, Qxu, Qxu, Qxu, Uh^Uf, Uu, Uh, Uh^Uf, Xu, Uu, Xu, Xu, Uu, Uh, Wwf, Wwf, Wwf, Wwg, Wwg, Wwg, Wwf, Uu^Uf, Uh^Uf, Xu, Xu, Xu, Xu, Xu, Xu, Xu, Xu, Xu, Xu, Xu, Xu, Xu, Xu, Xu, Xu, Xu, Xu, Xu, Xu, Xu
Xu, Xu, Uh, Uh, Uh, Xu, Xu, Qxu, Qxu, Urb, Qxu, Qxu, Qxu, Uu, Qxu, Uu, Xu, Wwf, Wwg, Wwf, Xu, Wwf, Wwf, Xu, Wwf, Wwf, Wwg, Wwg, Wwf, Uu^Uf, Uh, Xu, Xu, Xu, Xu, Xu, Xu, Xu, Xu, Xu, Xu, Xu, Xu, Xu, Xu, Xu, Xu, Xu, Xu, Xu, Xu, Xu
Xu, Xu, Qxu, Uu, Uu, Uh, Xu, Xu, Qxu, Urb, Uh, Xu, Xu, Qxu, Xu, Xu, Wwf, Wwf, Wwf, Wwf, Wwg, Uu, Wwf, Ur, Xu, Wwf, Wwf, Wwg, Uu, Wwf, Uu^Uf, Xu, Uh^Uf, Xu, Uu, Uh, Uh^Uf, Xu, Xu, Xu, Xu, Xu, Xu, Xu, Xu, Xu, Xu, Xu, Xu, Xu, Xu, Xu
Xu, Xu, Qxu, Qxu, Xu, Uh, Xu, Xu, Xu, Xu, Uh, Xu, Xu, Xu, Xu, Xu, Wwf, Wwg, Uh^Uf, Wwf^Uf, Ur, Wwf, Uu, Wwf, Uu^Uf, Uu, Wwg, Wwf, Wwf, Wwf, Uh, Uh^Uf, Uu, Uu, Ur, Xu, Xu, Uh^Uf, Uh^Uf, Xu, Xu, Xu, Xu, Xu, Xu, Xu, Xu, Xu, Xu, Xu, Xu, Xu
Xu, Uh^Dr, Uh^Dr, Xu, Xu, Xu, Xu, Xu, Xu, Xu, Xu, Wwf, Xu, Xu, Xu, Xu, Xu, Wwg, Wwf, Wwf, Uh^Uf, Wwf^Uf, Wwf, Xu, Xu, Wwg, Wwg, Wwf, Wwf, Wwf, Ur, Uh^Vud, Uu, Ur, Ur, Ur, Ur, Uu^Vud, Xu, Xu, Uh^Uf, Xu, Xu, Xu, Xu, Xu, Xu, Xu, Xu, Xu, Xu, Xu
Xu, Uh^Dr, Wwg, Xu, Wwf^Uf, Wwf^Uf, Xu, Xu, Xu, Xu, Xu, Wwf, Wwf, Xu, Wwf, Wwf, Wwf, Wwf, Wwf, Uu^Uf, Wwg, Wwg, Wwf, Uu^Vu, Xu, Uu^Uf, Wwf, Wwf, Wwg, Wwf, Uu, Uh^Uf, Cud, Cud, Cud, Ur, Ur, Uh, Uu, Uh, Uu, Xu, Xu, Xu, Xu, Xu, Xu, Xu, Xu, Xu, Xu, Xu
Xu, Xu, Uh, Wwg, Wwg, Wwg^Uf, Wwf^Uf, Wwf^Uf, Wwf, Xu, Wwf^Uf, Xu, Wwf, Ur, Xu, Xu, Xu, Xu, Wwf^Uf, Wwg, Wwf, Wwg, Wwf, Uu^Uf, Xu, Xu, Wwf, Wwf, Wwf, Uu, Cud, Uu, Cud, Cud, 2 Kud, Cud, Cud, Ur, Ur, Ur, Ur, Uh, Uh^Uf, Xu, Xu, Xu, Xu, Xu, Xu, Xu, Xu, Xu
Xu, Xu, Xu, Wwf, Wwf, Xu, Wwg, Wwg, Wwg, Wwf, Wwf, Wwf, Wwf, Wwf^Uf, Xu, Xu, Uu^Vu, Wwf, Xu, Wwg^Uf, Uu^Uf, Xu, Uh, Xu, Xu, Xu, Uu^Uf, Wwg, Wwg, Wwf, Uh^Uf, Uu, Ur, Cud, Cud, Cud, Cud, Ur, Uu, Ur, Uu^Uf, Uu, Uh, Xu, Xu, Xu, Xu, Xu, Xu, Xu, Xu, Xu
Xu, Xu, Xu, Uh^Uf, Wwf, Wwg, Wwg, Wwf, Wwf, Wwf, Uh^Uf, Uh, Xu, Uu^Uf, Uh, Uu, Xu, Uh, Xu, Uu^Uf, Xu, Xu, Wwf^Uf, Xu, Xu, Xu, Xu, Wwf, Wwf, Uu, Uh, Uh^Uf, Uu, Ur, Ur, Cud, Ur, Uu, Xu, Ur, Ur, Xu, Uu, Uh^Uf, Xu, Xu, Xu, Xu, Xu, Xu, Xu, Xu
Xu, Xu, Xu, Xu, Xu, Wwf^Uf, Xu, Uu^Uf, Xu, Xu, Xu, Uh, Uh, Uu, Wwf, Xu, Wwf, Wwf, Wwf, Wwg^Uf, Wwf, Wwf, Xu, Uh, Uh^Uf, Xu, Xu, Wwf, Wwf, Wwf, Wwf, Xu, Uu, Ur, Cud, Ur, Ur, Xu, Xu, Uu, Uu^Vud, Uu^Uf, Uh, Uh^Uf, Xu, Xu, Xu, Xu, Xu, Xu, Xu, Xu
Xu, Uh^Dr, Uh^Dr, Xu, Xu, Xu, Xu, Xu, Xu, Xu, Xu, Xu, Xu, Xu, Wwf, Wwf, Wwg, Wwg, Wwg, Wwf^Uf, Wwg^Uf, Wwf^Uf, Wwf, Uu^Uf, Xu, Xu, Xu, Xu, Wwf, Wwg, Wwf, Wwg, Uu, Uu, Uu^Vud, Uu, Ur, Ur, Ur, Uu, Uu, Uu, Uh^Uf, Xu, Xu, Xu, Xu, Xu, Xu, Xu, Xu, Xu
Xu, Uh^Dr, Wwf, Xu, Xu, Xu, Xu, Xu, Xu, Xu, Xu, Xu, Xu, Uh, Uu, Wwf, Wwf, Wwg, Wwg, Wwf, Xu, Wwg, Wwf, Uu^Uf, Xu, Xu, Xu, Xu, Xu, Wwg, Wwg, Wwg, Wwf, Uu, Uh, Uu, Ur, Uu, Ur, Ur, Uu, Uh, Uh^Uf, Xu, Xu, Xu, Xu, Xu, Xu, Xu, Xu, Xu
Xu, Uh^Dr, Wwg, Uu^Uf, Wwg^Uf, Xu, Uh^Uf, Xu, Xu, Xu, Xu, Xu, Xu, Xu, Uu^Vu, Wwf, Wwf^Uf, Wwg^Uf, Wwf, Wwf, Xu, Wwg, Wwg, Wwf, Xu, Xu, Xu, Xu, Xu, Wwf, Wwf, Wwg, Uu, Uh^Uf, Xu, Xu, Uu, Ur, Ur, Uu, Uu, Uu^Uf, Xu, Xu, Xu, Xu, Xu, Xu, Xu, Xu, Xu, Xu
Xu, Xu, Uu^Uf, Wwg, Uu^Uf, Uh^Uf, Uu, Xu, Xu, Xu, Xu, Xu, Xu, Xu, Xu, Uh, Wwf^Uf, Wwf^Uf, Xu, Xu, Xu, Uu^Uf, Uh, Uh, Wwf, Xu, Xu, Xu, Xu, Uu^Uf, Wwg, Wwf, Wwf, Uh^Uf, Xu, Xu, Xu, Uu, Ur, Ur, Uu, Xu, Xu, Xu, Xu, Xu, Xu, Xu, Xu, Xu, Xu, Xu
Xu, Xu, Xu, Wwg, Wwg, Wwf^Uf, Wwg, Wwg, Uu^Uf, Xu, Xu, Xu, Xu, Xu, Uh, Wwf, Wwf, Uh, Uu^Uf, Xu, Xu, Xu, Uu^Uf, Wwg, Wwf, Uu^Uf, Xu, Xu, Xu, Xu, Wwf, Uu, Wwg, Uu^Uf, Uu^Uf, Uh^Uf, Uu, Uu, Ur, Ur, Uu^Uf, Xu, Uu^Uf, Xu, Xu, Xu, Xu, Xu, Xu, Xu, Xu, Xu
Xu, Xu, Xu, Uh^Uf, Uh, Wwg, Wwg, Wwg, Wwg, Xu, Xu, Xu, Xu, Xu, Wwf, Wwf, Xu, Uu, Uu^Uf, Xu, Uu^Uf, Uh, Xu, Wwf, Wwg^Uf, Wwf^Uf, Wwf, Xu, Xu, Xu, Xu, Wwf, Wwg, Wwg, Ur, Ur, Ur, Ur, Ur, Uu^Uf, Xu, Uu^Uf, Ur, Uh^Uf, Uh, Xu, Uh^Uf, Xu, Xu, Xu, Xu, Xu
Xu, Xu, Xu, Xu, Uh^Uf, Xu, Wwg, Uu^Uf, Wwg, Wwg, Uu^Uf, Xu, Uh^Uf, Xu, Wwf^Uf, Wwf, Xu, Xu, Uu, Uu^Uf, Uu, Uu, Xu, Xu, Wwf, Wwg^Uf, Wwf, Xu, Xu, Xu, Xu, Wwf, Wwg, Wwg, Uu, Uu, Uu, Ur, Uu, Ur, Ur, Ur, Ur, Uu, Uh^Uf, Uh, Uu, Uu^Uf, Uu^Uf, Xu, Xu, Xu
Xu, Xu, Xu, Xu, Xu, Uh^Uf, Uh, Wwg, Wwf^Uf, Wwg^Uf, Wwf^Uf, Wwf, Wwg, Uh, Wwf, Xu, Xu, Xu, Xu, Uh, Xu, Xu, Xu, Xu, Xu, Wwg, Wwg, Wwf^Uf, Xu, Xu, Xu, Xu, Wwf, Uu, Wwg, Uh, Uh, Uu, Ur, Ur, Ur, Ur, Ur, Xu, Uu^Uf, Uu, Uu^Vud, Ur, Uu, Xu, Xu, Xu
Xu, Xu, Xu, Xu, Xu, Xu, Xu, Xu, Xu, Uu^Uf, Xu, Wwg, Uu, Wwg, Wwf, Xu, Xu, Xu, Uh, Uh^Uf, Uh^Uf, Xu, Xu, Xu, Xu, Wwf, Wwf, Wwf, Wwf^Uf, Xu, Xu, Uu^Uf, Wwf, Wwg, Wwf, Uh^Uf, Uh^Uf, Cud, Ur, Uu, Ur, Xu, Xu, Ur, Ur, Ur, Ur, Ur, Uu, Uh^Uf, Uh^Uf, Xu
Xu, Xu, Xu, Xu, Xu, Xu, Xu, Xu, Xu, Xu, Xu, Wwg, Wwg, Uh, Wwg, Wwf, Wwg^Uf, Wwg, Wwf, Wwf, Wwf, Uh^Uf, Uh, Xu, Xu, Xu, Xu, Wwf, Wwf, Xu, Uh, Uu^Uf, Uu^Uf, Wwg, Wwf, Uu, Uh, Uu, Uu^Vud, Uu, Uu, Ur, Ur, Ur, Ur, Ur, Ur, Uu, Uu, Uu^Uf, Xu, Uh^Uf
Xu, Xu, Xu, Xu, Xu, Xu, Xu, Xu, Xu, Xu, Xu, Xu, Xu, Xu, Uu, Wwf, Wwf^Uf, Wwf^Uf, Wwg, Wwg, Wwg, Wwf^Uf, Wwg, Wwg, Wwf, Uh^Uf, Uh^Uf, Wwf, Wwf, Xu, Uh^Uf, Xu, Xu, Wwf, Wwg, Uu, Uh^Uf, Uh, Uu, Uu, Ur, Ur, Cud, Cud, Cud, Ur, Uu, Uu, Uu^Uf, Uu, Uu, Uu
Xu, Xu, Xu, Xu, Xu, Xu, Xu, Xu, Xu, Xu, Xu, Xu, Xu, Xu, Uh, Ur, Ur, Xu, Xu, Wwg, Wwg^Uf, Uu^Uf, Wwg, Uu, Uu^Uf, Wwf, Uu, Uh, Uu, Wwf, Uh^Uf, Xu, Uu, Wwg, Wwf, Uu, Uu, Uh^Uf, Uh, Uu, Ur, Ur, Cud, Cud, 3 Kud, Cud, Cud, Uu, Xu, Xu, Uu^Uf, Uu
Xu, Xu, Xu, Xu, Xu, Xu, Xu, Xu, Xu, Xu, Xu, Xu, Xu, Uh^Uf, Uh, Xu, Ur, Uu, Uh^Uf, Uh, Xu, Wwg, Xu, Wwf, Wwg, Wwg, Wwg, Wwg, Wwg, Wwf, Uu, Uh^Uf, Uh, Wwf, Wwf, Wwg, Uu, Uh, Cud, Uu, Uu, Ur, Ur, Cud, Cud, Cud, Cud, Uu, Uu, Xu, Uh^Uf, Uh^Uf
Xu, Xu, Xu, Xu, Xu, Xu, Xu, Xu, Xu, Xu, Xu, Xu, Xu, Uh^Uf, Uh^Uf, Uu, Ur, Uh^Uf, Uh^Uf, Xu, Xu, Xu, Xu, Wwg, Wwg^Uf, Wwg, Wwg, Uu, Wwg, Wwf, Wwf, Uh, Uu, Wwg, Wwf, Wwg, Uu^Uf, Xu, Uu, Uu, Xu, Ur, Ur, Ur, Ur, Cud, Ur, Ur, Uu, Uu^Vud, Uh^Uf, Xu
Xu, Xu, Xu, Xu, Xu, Xu, Xu, Xu, Xu, Xu, Xu, Xu, Xu, Xu, Uu, Uu^Uf, Ur, Uh, Xu, Xu, Xu, Xu, Xu, Xu, Xu, Xu, Uh, Uu^Uf, Wwf, Wwf, Wwf, Uu, Wwg, Xu, Wwf, Wwf, Wwg, Uu, Uh, Uu^Uf, Uu^Vud, Uu, Xu, Ur, Uu, Ur, Ur, Uu, Xu, Uu^Uf, Xu, Xu
Xu, Xu, Xu, Xu, Xu, Xu, Xu, Xu, Xu, Xu, Xu, Xu, Xu, Uh^Uf, Uh, Ur, Uu, Xu, Xu, Xu, Xu, Xu, Xu, Xu, Xu, Uh^Uf, Uu^Uf, Xu, Ur, Wwf, Wwg, Wwf, Wwf, Wwf, Wwf, Wwg, Wwg, Uu, Uh^Uf, Uh, Uu, Uh, Xu, Xu, Uh^Uf, Uu, Ur, Cud, Xu, Xu, Xu, Xu
Xu, Xu, Xu, Xu, Xu, Xu, Xu, Xu, Xu, Xu, Xu, Xu, Xu, Xu, Uu, Ur, Xu, Uh, Xu, Xu, Xu, Xu, Xu, Xu, Xu, Xu, Uu, Xu, Ur, Xu, Ur, Wwf, Uu, Wwf, Wwf, Wwg, Wwf, Uu, Xu, Uu, Xu, Uh^Uf, Xu, Xu, Xu, Uu, Ur, Xu, Xu, Xu, Xu, Xu
Xu, Xu, Xu, Xu, Xu, Xu, Xu, Xu, Xu, Xu, Xu, Xu, Xu, Xu, Ur, Ur, Xu, Uh^Uf, Uh^Uf, Xu, Xu, Xu, Xu, Xu, Xu, Xu, Xu, Ur, Uu, Ur, Ur, Xu, Uu^Uf, Wwf, Wwg, Wwf, Wwf, Xu, Xu, Uu^Uf, Xu, Uh, Uh^Uf, Uh^Uf, Uh, Uu, Uu, Uh^Uf, Xu, Xu, Xu, Xu
Xu, Xu, Xu, Xu, Xu, Xu, Xu, Xu, Xu, Xu, Xu, Xu, Uh^Uf, Uu, Uu, Ur, Uu^Vu, Xu, Uh^Uf, Xu, Xu, Xu, Xu, Xu, Xu, Xu, Uu^Vu, Ur, Ur, Uu, Uh, Uh, Xu, Wwf^Uf, Wwf, Wwg, Wwf, Wwf^Uf, Uh, Uh, Uh^Uf, Uh^Uf, Xu, Uh, Uh^Uf, Uh^Uf, Uu^Uf, Uh^Uf, Xu, Xu, Xu, Xu
Xu, Xu, Xu, Xu, Xu, Xu, Xu, Xu, Qxu, Xu, Uh, Uh, Uu, Ur, Ur, Ur, Uu, Xu, Uh^Uf, Xu, Xu, Xu, Xu, Xu, Xu, Uh, Ur, Ur, Ur, Uu, Uh^Uf, Xu, Xu, Xu, Xu, Wwg, Wwg, Wwf, Wwf, Xu, Uu^Uf, Xu, Xu, Uh^Uf, Uh^Uf, Uh^Uf, Ur, Uu^Uf, Uh^Uf, Xu, Xu, Xu
Xu, Xu, Xu, Xu, Xu, Xu, Uh, Uh, Qxu, Qxu, Xu, Xu, Uh, Ur, Ur, Ur, Ur, Uh^Uf, Xu, Xu, Xu, Xu, Xu, Xu, Xu, Uh^Uf, Uu, Ur, Uu, Uh, Xu, Uh, Uh^Uf, Uh^Uf, Uh^Uf, Wwf^Uf, Wwf, Wwg, Wwf, Wwg, Wwg, Xu, Xu, Xu, Xu, Xu, Ur, Uh^Uf, Xu, Xu, Xu, Xu
Xu, Xu, Xu, Xu, Xu, Uh^Uf, Uh, Uu, Xu, Qxu, Xu, Xu, Uh^Uf, Uu, Ur, Ur, Uu, Uu^Uf, Xu, Xu, Xu, Xu, Xu, Xu, Xu, Xu, Uu, Ur, Uu, Xu, Xu, Xu, Xu, Xu, Xu, Xu, Xu, Wwg, Wwg, Wwf, Wwf, Wwf^Uf, Wwg^Uf, Xu, Xu, Ur, Uu, Uh, Uh^Uf, Xu, Xu, Xu
Xu, Xu, Xu, Xu, Xu, Xu, Uh^Uf, Uh, Uh^Uf, Uh, Xu, Xu, Xu, Uu^Vu, Uu, Ur, Ur, Xu, Uh^Uf, Xu, Xu, Xu, Xu, Xu, Xu, Xu, Ur, Xu, Xu, Xu, Xu, Xu, Xu, Xu, Xu, Xu, Uh, Uu^Uf, Uu, Wwg, Wwg, Wwf, Wwf, Xu, Ur, Uu, Uu^Uf, Uh^Uf, Xu, Xu, Xu, Xu
Xu, Xu, Xu, Xu, Xu, Xu, Xu, Uh^Uf, Xu, Xu, Xu, Xu, Xu, Xu, Xu, Xu, Uh, Ur, Ur, Xu, Xu, Xu, Xu, Xu, Xu, Uu, Ur, Xu, Xu, Xu, Xu, Xu, Xu, Xu, Xu, Xu, Uh^Uf, Xu, Xu, Xu, Xu, Wwf, Wwf, Wwg, Wwg, Ur, Xu, Xu, Xu, Xu, Xu, Xu
Xu, Xu, Xu, Xu, Xu, Xu, Xu, Xu, Xu, Xu, Xu, Xu, Xu, Xu, Xu, Xu, Xu, Uh^Uf, Ur, Uu, Xu, Xu, Xu, Xu, Uu, Ur, Xu, Xu, Xu, Xu, Xu, Xu, Xu, Xu, Xu, Xu, Uh^Uf, Xu, Xu, Xu, Uu, Wwf, Wwf, Wwf, Wwf, Wwf, Wwf^Uf, Xu, Xu, Xu, Xu, Xu
Xu, Xu, Xu, Xu, Xu, Xu, Xu, Xu, Xu, Xu, Xu, Xu, Xu, Xu, Xu, Xu, Xu, Xu, Uh, Ur, Uu, Uh, Xu, Xu, Ur, Ur, Xu, Xu, Xu, Xu, Xu, Xu, Xu, Xu, Xu, Uh^Uf, Uh, Xu, Xu, Uu^Uf, Ur, Ur, Ur, Wwg^Uf, Wwg^Uf, Wwg, Wwg, Uu^Uf, Xu, Xu, Xu, Xu
Xu, Xu, Xu, Xu, Xu, Xu, Xu, Xu, Xu, Xu, Xu, Xu, Xu, Xu, Xu, Xu, Xu, Xu, Xu, Uu, Ur, Uu, Uu, Uu, Ur, Uu, Xu, Xu, Xu, Xu, Xu, Xu, Xu, Uh^Uf, Uu, Uh^Uf, Uu^Uf, Xu, Uu, Ur, Ur, Uu, Uu^Uf, Xu, Wwg^Uf, Wwg, Wwf, Wwf, Wwf^Uf, Xu, Xu, Xu
Xu, Xu, Xu, Xu, Xu, Xu, Xu, Xu, Xu, Xu, Xu, Xu, Xu, Xu, Xu, Xu, Xu, Xu, Uh^Uf, Uu, Ur, Xu, Uu, Ur, Uh^Uf, Xu, Xu, Xu, Xu, Xu, Xu, Xu, Uu, Uh, Ur, Ur, Ur, Uu, Ur, Ur, Xu, Xu, Xu, Xu, Xu, Wwg, Wwg, Wwg, Wwf, Xu, Xu, Xu
Xu, Xu, Xu, Xu, Xu, Xu, Xu, Xu, Xu, Xu, Xu, Xu, Xu, Xu, Xu, Xu, Xu, Xu, Uh, Uu, Ur, Ur, Ur, Ur, Xu, Xu, Xu, Xu, Ur, Uu, Ur, Ur, Ur, Ur, Ur, Ur, Ur, Ur, Uh, Xu, Xu, Xu, Xu, Xu, Xu, Uh, Wwg^Uf, Wwg, Wwf, Wwf^Uf, Wwf, Xu
Xu, Xu, Xu, Xu, Xu, Xu, Xu, Xu, Xu, Xu, Xu, Xu, Xu, Xu, Xu, Xu, Uh^Uf, Uh^Uf, Uu, Ur^Vct, Ur, Ur, Uu, Ur, Ur, Xu, Ur, Ur, Uu, Ur, Uh^Uf, Xu, Xu, Uu, Xu, Uu^Vu, Uu, Uh^Uf, Xu, Xu, Xu, Xu, Xu, Xu, Xu, Xu, Uh^Uf, Wwg^Uf, Wwg, Wwf, Wwg, Wwf
Xu, Xu, Xu, Xu, Xu, Xu, Xu, Xu, Xu, Xu, Xu, Xu, Xu, Xu, Uh^Uf, Xu, Uh, Xu, Uu, Ur, Ur, Ur, Uu, Uu, Uh^Uf, Ur, Xu, Xu, Xu, Uh^Uf, Xu, Xu, Xu, Xu, Xu, Xu, Xu, Xu, Xu, Xu, Xu, Xu, Xu, Xu, Xu, Xu, Xu, Xu, Uh^Uf, Wwg, Wwf^Uf, Wwf
Xu, Xu, Xu, Xu, Xu, Xu, Xu, Xu, Xu, Xu, Xu, Xu, Xu, Uh^Uf, Uh, Uh^Uf, Uu, Uu, Ce, Ur, Ur, Uu, Uu, Uh, Uh^Uf, Xu, Xu, Xu, Xu, Xu, Xu, Xu, Xu, Xu, Xu, Xu, Xu, Xu, Xu, Xu, Xu, Xu, Xu, Xu, Xu, Xu, Uh, Xu, Qxu, Uu, Uu^Uf, Wwg
Xu, Xu, Xu, Xu, Xu, Xu, Xu, Xu, Xu, Xu, Xu, Xu, Uh^Uf, Uh^Uf, Uh, Uh, Uu, Ce, 1 Ke, Ce, Uu, Uu^Vct, Uh, Uh^Uf, Xu, Xu, Xu, Xu, Xu, Xu, Xu, Xu, Xu, Xu, Xu, Xu, Xu, Xu, Xu, Xu, Xu, Xu, Xu, Xu, Xu, Uh, Uh, Uu, Uu, Qxu, Xu, Uh^Uf
Xu, Xu, Xu, Xu, Xu, Xu, Xu, Xu, Xu, Xu, Xu, Xu, Uh^Uf, Uh, Uu^Vct, Uu, Uu, Ce, Ce, Ce, Uu, Uu, Uh^Uf, Uh^Uf, Xu, Xu, Xu, Xu, Xu, Xu, Xu, Xu, Xu, Xu, Xu, Xu, Xu, Xu, Xu, Xu, Xu, Xu, Xu, Xu, Xu, Xu, Uh, Uh, Uu, Uu, Uh, Xu
Xu, Xu, Xu, Xu, Xu, Xu, Xu, Xu, Xu, Xu, Xu, Uh^Uf, Uh^Uf, Uu, Uu, Uu, Uu, Uu, Uu, Uu, Uu, Uu^Uf, Uh^Uf, Xu, Xu, Xu, Xu, Xu, Xu, Xu, Xu, Xu, Xu, Xu, Xu, Xu, Xu, Xu, Xu, Xu, Xu, Xu, Xu, Xu, Xu, Xu, Xu, Xu, Xu, Xu, Xu, Xu
