border_size=1
usage=map

Xu, Xu, Xu, Xu, Xu, Xu, Xu, Xu, Xu, Xu, Xu, Xu, Xu, Xu, Xu, Xu, Xu, Gd, Ms^Xm, Ms^Xm, Ms^Xm, Ms^Xm, Ms^Xm, Ms^Xm, Ms^Xm, Ms^Xm, Ms, Ms, Ms, Ms, Ha, Ha, Ha^Fpa, Gd, Aa, Aa, Aa, Aa, Aa^Fma, Ha^Fma, Ha, Ha, Ha^Fma, Ms^Xm, Ms^Xm, Gd, Ms, Ms, Ms, Ms, Ms, Ms, Ms, Ms, Ms, Ms^Xm, Ms^Xm, Ms^Xm, Ms^Xm, Gd, Ms^Xm, Gd, Ms^Xm, Ms^Xm, Ms^Xm, Ms, Ms, Ms, Ms, Ms
Xu, Xu, Xu, Xu, Xu, Xu, Xu, Xu, Xu, Xu, Xu, Xu, Xu, Xu, Xu, Xu, Ms^Xm, Ms^Xm, Ms^Xm, Ms^Xm, Ms^Xm, Ms^Xm, Ms, Ms^Xm, Ms^Xm, Ms^Xm, Ms, Ms, Ms, Ms, Ha, Ha, Ha, Aa, Aa, Aa, Aa, Aa, Aa, Ha^Fma, Ha^Fma, Ha^Fma, Ha^Fma, Ha, Ms^Xm, Ms^Xm, Ms^Xm, Ms, Ms, Ms, Ms, Ms, Ms, Ms, Ms, Ms^Xm, Ms^Xm, Ms^Xm, Ai, Ms^Xm, Ms^Xm, Ms^Xm, Ms^Xm, Ms^Xm, Ms^Xm, Ms, Ms, Ms, Ha, Ha
Xu, Xu, Xu, Xu, Xu, Xu, Xu, Xu, Xu, Xu, Xu, Xu, Xu, Xu, Xu, Xu, Ms^Xm, Ms^Xm, Ms^Xm, Ms^Xm, Ms, Ms, Ms, Ms, Ms, Ms^Xm, Ms^Xm, Ms, Ms, Ms, Ha, Ha^Fpa, Ha^Fpa, Ha^Voa, Gd, Gd, Aa, Aa, Aa, Aa, Aa, Ha, Ha^Fma, Ha, Ha, Ms^Xm, Ms^Xm, Ms^Xm, Ms^Xm, Ms, Ha, Ms, Ms, Ms, Ms, Ms, Ms, Ai, Ms^Xm, Ms^Xm, Ms^Xm, Ms^Xm, Ms^Xm, Ms^Xm, Ms, Ms^Xm, Ms^Xm, Ms, Ha^Fpa, Ha^Fpa
Xu, Xu, Xu, Xu, Xu, Xu, Xu, Xu, Xu, Xu, Xu, Xu, Xuce, Xu, Xu, Xu, Xu, Ms^Xm, Ms^Xm, Ms^Xm, Ms, Ms, Ms, Ms, Ms, Ms, Ms, Ms, Ms, Ms, Ms, Ha, Ha^Fpa, Ha^Fpa, Ha, Gd, Gd, Aa, Aa, Gd, Aa, Aa, Ha^Fma, Ha, Ha, Ms^Xm, Ms^Xm, Ms^Xm, Ms^Xm, Ha, Ha, Ha, Ha, Ms, Ms, Ms, Ai, Ai, Ms, Ms^Xm, Ms, Ms^Xm, Ms^Xm, Ms, Ms, Ms, Ms^Xm, Ms^Xm, Ha^Fpa, Ha^Fpa
Xu, Xu, Xu, Xu, Xu, Xu, Xu, Xu, Xu, Xu, Xu, Xu, Xuce, Xu, Xu, Xu, Xu, Xu, Xu, Xu, Ha, Ha, Ha, Ms, Ms, Ms, Ms, Ms, Ms, Ms, Ms, Ha, Ha, Ha^Fpa, Ha^Fpa, Gd, Aa, Aa, Aa, Gd, Aa, Ha, Ha^Vha, Ha^Fma, Ha, Ms^Xm, Ms^Xm, Ms^Xm, Ms^Xm, Ha, Ha^Fpa, Ha^Fpa, Ha, Ms, Ai, Ai, Ms, Ms, Ms, Ms, Ms, Ms, Ms, Ms, Ms, Ms, Ms^Xm, Ha, Ha^Fpa, Ha^Fpa
Xu, Xu, Xu, Xu, Xu, Xu, Xuce, Xu, Xu, Xu, Xu, Xu, Xuce, Xu, Xu, Xu, Xu, Xu, Xu, Xu, Ha, Ha^Fpa, Ha^Fma, Ha, Ms, Ms, Ms, Ms, Ms^Xm, Ms, Ms, Ms, Ha, Ha^Fpa, Cea, Ha, Gd, Gd, Gd, Aa, Aa, Aa, Ha, Ha, Ha, Ms, Ms^Xm, Ms^Xm, Ms, Ha, Aa^Fpa, Ha, Ai, Ai, Ha, Ha^Vha, Aa, Ms, Ms, Ms, Ms, Ms, Ms, Ms, Ms, Ms, Ha, Aa, Ha^Fpa, Ha
Xu, Xu, Xuce, Xu, Xu, Xu, Xu, Xu, Xu, Xu, Xu, Xu, Xu, Xu, Xu, Xu, Xu, Xu, Xu, Xu, Aa, Ha, Aa^Fma, Ha^Fma, Ha, Ms, Ha, Ms, Ha, Ha, Ha, Ha, Ce, Ce, 3 Kea, Cea, Cea, Gd, Aa, Aa, Aa, Aa, Aa, Aa, Ha, Ha, Ha, Ha, Ha, Ha^Fpa, Aa^Fpa, Ai, Ha, Ha^Fpa, Aa, Aa, Ha, Ha, Ha, Ha^Fma, Ha^Fma, Ms, Ms, Ms, Ms, Ha, Ha^Fpa, Ha^Fpa, Aa^Fpa, Aa
Xuce, Xuce, Xuce, Xuce, Xuce, Xu, Xu, Xu, Xu, Xu, Xu, Xu, Xu, Xu, Xu, Xu, Xu, Xu, Xu, Xu, Aa, Aa, Aa, Aa^Fma, Ha^Fma, Ha, Ha, Ha, Aa, Ha, Aa, Ha, Cea, Ce, Ce, Cea, Cea, Cea, Gd, Aa, Wwf, Aa, Ha, Aa, Aa, Ha, Aa, Ha, Ha, Ms, Ai, Ai, Ha, Aa, Cha, Aa^Fma, Cha, Cha, Cha, Ha, Ha, Ha^Fma, Ha^Fma, Ms, Aa, Aa, Ha^Fma, Aa, Ha, Ha
Xuce, Xuce, Xuce, Xuce, Xuce, Xu, Xu, Xu, Xu, Xuce, Xu, Xu, Xu, Xu, Xu, Xu, Xu, Xu, Xu, Xu, Aa, Aa, Aa^Fpa, Ha, Ha, Ha^Fma, Ha^Fma, Ha^Fma, Ha^Voa, Aa, Ha, Aa, Aa, Cea, Ai, Cea, Gd, Ha, Ha, Sm, Aa, Wwf, Gd, Ha, Ha, Aa, Aa, Aa, Aa, Ai, Ai, Ai, Cha, Cha, Cha, 2 Kha, Cha, Cha, Cha, Ha, Ha, Ha, Ha, Ha^Fma, Ha^Fpa, Ha^Fma, Ha^Fpa, Aa, Gd, Gd
Xuce, Xuce, Xuce, Xuce, Xu, Xu, Xu, Xu, Xu, Xu, Xu, Xu, Xu, Xu, Xu, Xu, Xu, Xu, Xu, Xu, Aa, Aa^Fpa, Gd, Gd, Gd, Ha, Gd, Ha, Gd, Gd, Gd, Gd, Sm, Sm, Wwf, Gd, Ha, Ha, Ha, Gd, Gd, Gd, Aa, Gd, Ai, Ai, Aa, Aa^Vha, Gd, Ai, Ai, Ai, Aa, Cha, Gd, Cha, Gd, Cha, Gd, Ha, Gd, Ha, Ha, Ha^Vha, Ha, Ha^Fpa, Gd, Gd, Gd, Gd
Xuce, Xuce, Xuce, Xuce, Xuce, Xuce, Xuce, Xuce, Xu, Xu, Xuce, Xuce, Xuce, Xuce, Xu, Xu, Xuce, Xu, Gd, Gd, Aa^Fpa, Aa, Gd, Gd, Gd, Gd, Aa, Gd, Aa^Fma, Gd, Gd, Gd, Gd, Wwf, Wwf, Gd, Gd, Ha, Ha, Ha, Ha^Fpa, Aa^Fpa, Sm, Aa, Ss, Wwf, Wwf, Gd, Gd, Gd, Aa, Aa, Gd, Gd, Aa, Gd, Aa, Gd, Aa, Aa, Gd, Ha, Ha, Ha, Ha, Aa, Aa, Aa, Gd, Gd
Xu, Xuce, Xuce, Xuce, Xuce, Xuce, Xu, Xu, Xu, Xuce, Xuce, Xuce, Xuce, Xuce, Xu, Xuce, Xuce, Xuce, Ai, Aa, Aa, Aa^Fpa, Gd, Aa, Gd, Aa, Aa, Gd, Aa^Fma, Aa, Aa, Aa, Gd^Fpa, Gd^Fpa, Aa^Fpa, Aa^Fpa, Aa^Fpa, Aa, Aa, Ha, Aa^Fpa, Ha, Ai, Sm, Ss, Wwf, Aa, Gd, Sm, Gd, Gd, Aa, Gd, Aa, Aa, Ss, Sm, Aa, Gd, Aa, Gd, Gd, Gd, Aa, Aa, Gd, Ha, Ha, Aa, Ms
Xu, Xu, Xu, Xu, Xu, Xuce, Xuce, Xu, Xu, Xuce, Xuce, Xuce, Xuce, Xuce, Xu, Xuce, Xuce, Xuce, Ai, Aa, Gd^Fpa, Aa, Aa, Gd, Gd, Gd, Gd, Gd, Ha^Fpa, Aa^Fma, Aa^Fma, Aa^Fma, Ha^Fpa, Ha^Fpa, Gd, Aa, Gd^Fpa, Gd^Fpa, Gd, Aa, Aa, Ai, Wwf, Ai, Wwf, Ai, Gd, Sm, Gd, Aa, Aa, Wwf, Wwf, Aa, Wwf, Wwf, Wwf, Sm, Aa, Gd, Gd, Gd, Aa^Fma, Aa, Ha^Fma, Gd^Fma, Aa, Ha, Ha, Ha
Xu, Xu, Xu, Xu, Xu, Xu, Xu, Xu, Xu, Xu, Xu, Xuce, Xuce, Xu, Xuce, Xu, Xuce, Ai, Aa^Fpa, Aa^Fpa, Aa^Fpa, Aa, Aa, Gd, Aa, Gd, Ha, Ha, Ha^Fpa, Aa^Fpa, Aa, Gd^Fpa, Ha, Ha^Fpa, Aa, Aa, Ss, Gd, Gd, Gd, Aa, Gd, Aa, Wwf, Aa, Gd, Aa, Gd, Sm, Sm, Ai, Aa, Ha, Aa, Ha^Fpa, Ai, Aa, Aa, Gd, Gd, Aa, Gd^Fma, Ha, Ha, Aa, Ha^Fma, Aa, Aa, Ha, Ha
Xu, Xu, Xu, Xu, Xu, Xu, Xu, Xu, Xu, Xu, Xu, Xu, Xu, Xu, Gd, Xuce, Aa, Gd, Aa, Ha, Gd^Fpa, Gd, Ha, Ha, Ha, Ha, Gd, Aa, Aa, Gd, Aa, Gd, Gd^Fpa, Gd^Fpa, Aa, Ai, Wwf, Wwf, Ai, Gd, Ha^Fma, Aa^Fma, Ha^Fma, Aa^Fma, Ha^Fma, Gd, Aa, Aa, Ai, Wwf, Wwf, Ai, Gd, Ha, Ha^Fpa, Aa^Fpa, Aa^Fpa, Gd, Gd, Gd, Aa, Aa, Aa, Aa, Cv, Ha, Cv, Ha, Ms, Ms
Xu, Xu, Xu, Xu, Xu, Xu, Xu, Xu, Xu, Xu, Xu, Xu, Xu, Xu, Gd, Gd, Aa, Aa, Gd, Gd, Aa, Aa, Aa, Aa, Aa, Gd, Aa, Gd, Wwf, Aa, Aa^Voa, Gd, Aa, Aa, Ss, Ai, Sm, Wwf, Aa, Gd^Fma, Gd^Fma, Aa, Aa, Ha^Fma, Aa^Fma, Aa, Ha, Gd, Ai, Wwf, Sm, Sm, Aa, Gd, Gd, Aa^Fpa, Gd, Gd, Gd, Ha^Vha, Ha, Ha, Cv, Cv, 4 Kha, Cv, Cv, Ha, Ms^Xm, Ms^Xm
Xu, Xu, Xu, Xu, Xu, Xu, Xu, Xu, Xu, Xu, Xu, Xu, Xu, Xu, Gd, Gd, Gd, Aa, Aa, Aa^Fma, Gd^Fma, Aa^Fma, Gd, Aa^Fma, Ha, Aa^Fma, Gd, Wwf, Ss, Gd, Gd, Gd, Gd, Aa, Gd, Sm, Aa, Aa, Sm, Gd, Aa, Gd^Voa, Gd, Gd, Gd, Ha, Gd, Aa^Fma, Aa, Aa^Fma, Aa, Aa, Aa, Ss, Wwf, Ss, Gd, Gd, Ha, Ha, Ha^Fpa, Ha, Cv, Cv, Cv, Cv, Ms, Ms, Ms, Ms^Xm
Xu, Xu, Xu, Xu, Xu, Xu, Xu, Xu, Xu, Xu, Xu, Xu, Xu, Xu, Gd, Gd, Aa, Aa^Voa, Aa, Aa^Fma, Aa, Aa, Gd, Gd, Ha, Ha, Ha, Ss, Ss, Sm, Sm, Gd, Gd, Aa, Aa^Fpa, Aa^Fpa, Aa^Fpa, Aa, Aa^Fpa, Aa, Aa, Aa, Aa, Aa, Sm, Gd, Gd, Aa, Aa, Aa^Fma, Aa^Fma, Aa^Fma, Gd, Ss, Wwf, Wwf, Gd, Gd, Ha, Ha, Ha, Ha, Ha^Fpa, Ha, Ms, Ms, Ms, Ms, Ms, Ms^Xm
Xu, Xu, Xu, Xu, Xu, Xu, Xu, Xu, Xuce, Xuce, Xuce, Xuce, Xu, Aa^Fma, Aa^Fma, Ha, Aa^Fma, Aa, Aa, Aa, Aa, Aa, Gd, Gd, Aa^Fpa, Aa^Fpa, Ha, Aa^Fpa, Aa^Fpa, Sm, Gd, Wwf, Gd, Aa^Fpa, Ha, Ha, Aa, Sm, Aa^Fpa, Aa, Gd, Aa, Gd, Sm, Ss, Sm, Sm, Aa^Fma, Ha^Fma, Aa^Fma, Aa^Fma, Gd, Aa, Aa, Aa^Fma, Gd, Sm, Wwf, Ai, Ha, Ha, Ha^Fpa, Aa, Ha, Ha, Ms, Ms, Ms, Ms, Ms^Xm
Xu, Xu, Xu, Xu, Xu, Xu, Xu, Xu, Xu, Xuce, Xuce, Xuce, Xuce, Aa^Fma, Ha, Ha, Gd, Gd, Aa, Gd, Gd, Gd, Gd, Aa^Voa, Aa, Aa^Fpa, Aa^Fpa, Ha^Fpa, Wwf, Ai, Gd, Gd, Gd, Aa, Aa, Ha, Ha, Ha, Aa^Fpa, Gd, Gd, Aa, Gd, Sm, Sm, Ss, Aa, Gd, Ha, Ha, Aa^Fma, Gd, Ha, Gd^Vha, Aa, Aa, Gg, Ai, Aa^Fpa, Aa, Aa^Fpa, Ha^Fpa, Ha^Fpa, Aa, Aa, Ha, Ha, Ms, Ms, Ms^Xm
Uu, Xu, Xu, Xu, Xu, Xu, Xu, Xu, Xu, Xuce, Xuce, Xuce, Gd, Ha, Gd, Gd, Aa, Gd, Aa, Aa, Gd, Wwf, Wwf, Gd, Gd, Gd, Aa, Ai, Wwf, Wwf, Aa, Gd, Aa, Aa, Aa, Aa, Ai, Aa^Fpa, Aa^Fpa, Aa, Aa, Gd, Wwf, Gd, Gd, Aa^Fpa, Ha^Fpa, Ha, Ha^Fpa, Ha^Fma, Aa, Aa, Aa^Fma, Ha^Fpa, Ha^Fma, Aa^Fpa, Gg, Ai, Gd, Gd, Aa, Aa, Gd^Fpa, Ha, Ha^Fpa, Aa, Ha, Ms, Ms, Ms
Uu, Uu^Uf, Uu, Xu, Xu, Xu, Xu, Xu, Xuce, Xuce, Xuce, Xuce, Gd, Gd, Gd, Gd, Coa, Coa, Coa, Coa, Coa, Wwf, Gd, Ai, Gd, Gd, Gd, Gd, Aa, Gd, Gd, Aa^Vha, Aa, Aa, Ss, Ai, Wwf, Wwf, Aa, Aa, Gd, Wwf, Sm, Sm, Aa, Aa^Vha, Aa^Fma, Gd, Aa, Ha^Fpa, Aa^Fpa, Aa^Fpa, Aa^Fma, Ha^Fma, Ha^Fma, Ha, Gg, Gg, Ha, Ha, Ha, Ha, Ha, Gd^Fpa, Ha^Fpa, Ha, Ha, Ha, Ha, Ms
Uu, Uu, Uu, Aa, Aa, Xu, Aa, Xu, Gd, Aa, Wwf, Aa, Gd, Gd, Coa, Coa, 1 Koa, Coa, Coa, Coa, Gd, Gd, Gd, Gd, Ha, Aa^Fma, Ha, Gd, Gd, Aa, Gd, Aa, Gd, Aa, Sm, Ss, Aa, Wwf, Aa, Gd, Gd, Aa, Gd, Ss, Gd, Wwf, Wwf, Gd, Gd, Aa^Fpa, Aa^Fpa, Aa^Fpa, Ha^Fpa, Ha^Fpa, Ha, Ha^Fma, Gg, Gg, Aa^Fma, Aa^Fma, Gd, Ha, Aa^Fma, Aa, Aa, Aa^Vea, Ha^Fpa, Ha, Ha, Ha
Uh, Uh, Uu, Aa, Aa, Aa, Wwf, Wwf, Aa, Wwf, Aa, Aa, Aa, Gd, Sm, Coa, Coa, Coa, Coa, Gd, Gd, Gd, Gd, Ha, Aa^Fma, Aa^Fma, Gd, Gd, Aa, Aa, Gd, Gd, Gd, Aa, Gd, Aa, Gd^Fpa, Aa^Vha, Gd, Gd, Aa, Aa, Sm, Sm, Wwf, Wwf, Gd, Aa, Aa^Fpa, Aa^Fma, Ha^Fma, Ha^Fma, Ha, Aa, Aa, Aa, Aa, Aa^Fma, Aa, Aa^Vea, Aa, Aa^Fma, Aa, Gd, Aa, Gd, Ha, Ha^Fpa, Ha, Ha
Xuce, Uh, Ai, Wwf, Gd, Aa, Aa, Ai, Gd, Gd, Gd, Wwf, Wwf, Aa, Aa, Sm, Aa, Coa, Coa, Gd, Gd, Gd^Vo, Gd, Gd, Ss, Ss, Aa, Aa, Aa, Aa, Ai, Wwf, Ss, Gd, Gd, Aa^Fpa, Sm, Gd^Fpa, Gd, Aa, Aa, Ss, Sm, Sm, Aa, Aa, Aa, Aa^Fpa, Aa^Fpa, Gd, Gd, Gd, Ha^Fpa, Aa^Fpa, Ha^Fpa, Gd, Gd, Aa^Fma, Aa, Gd, Gd, Aa, Aa, Gd, Aa, Gd, Gd, Ha, Aa, Gd
Xuce, Xuce, Xuce, Gd, Xuce, Ss, Xuce, Xuce, Xuce, Xuce, Xuce, Gd, Gd, Wwf, Wwf, Gd, Aa, Aa, Gd, Gd, Gd, Gd, Ss, Ss, Ss, Aa, Aa, Aa, Aa^Voa, Aa, Ai, Ai, Ss, Ss, Aa, Aa^Fpa, Aa^Fpa, Sm, Aa^Fpa, Aa^Fpa, Aa, Aa, Aa, Aa, Aa, Gd, Aa, Aa, Aa, Gd, Gd, Gd, Gd, Aa^Fpa, Aa^Fpa, Aa^Fpa, Aa^Fpa, Gd, Gd, Gd, Ai, Ai, Ai, Aa, Aa, Aa, Gd^Fpa, Aa, Gd, Gd
Xuce, Xuce, Xuce, Xuce, Xuce, Xuce, Xuce, Xuce, Xuce, Xuce, Xuce, Gd, Wwf, Wwf, Aa, Gd, Aa^Fpa, Gd, Aa, Aa, Aa, Gd, Gd, Ss, Sm, Aa, Aa, Aa, Aa^Fma, Aa, Aa, Aa, Gd, Ss, Aa, Aa, Ha^Fpa, Aa^Fpa, Gd^Fpa, Gd, Aa, Wwf, Sm, Aa, Aa, Aa, Aa, Gd, Aa, Gd^Vha, Gd, Gd, Gd, Gd, Aa^Fpa, Aa, Aa^Fpa, Aa^Fpa, Gd, Gd, Ai, Ai, Ha, Ai, Ha, Ha^Fpa, Ha^Fpa, Gd, Ha^Fpa, Gd
Xuce, Xuce, Xuce, Xuce, Xuce, Xuce, Xuce, Xuce, Xuce, Xuce, Xuce, Gd, Gd, Wwf, Aa, Aa^Fpa, Ha^Fpa, Gd^Fpa, Aa, Aa, Aa, Aa, Gd, Sm, Aa, Aa^Fma, Aa^Fma, Aa, Aa^Fma, Aa, Gd, Aa, Aa, Ha, Aa, Ha, Ha, Gd^Voa, Gd, Aa, Sm, Wwf, Ss, Aa, Aa, Gd, Wwf, Wwf, Sm, Gd, Gd, Aa, Aa, Gd, Gd, Aa, Gd, Wwf, Cud, Gd, Cud, Ha, Ha^Vha, Ai, Ai, Ha^Fpa, Ai, Ha^Fpa, Ha^Fpa, Ha
Xuce, Xuce, Xuce, Xuce, Xuce, Xuce, Xuce, Xuce, Xuce, Xuce, Xuce, Gd, Aa^Voa, Aa, Aa, Aa, Ha^Fma, Ha^Fpa, Ha^Fpa, Gd, Ha^Fpa, Aa, Gd, Gd, Aa, Aa, Aa^Fma, Aa, Aa^Fma, Gd, Wwf, Wwf, Aa, Ha, Gd^Fma, Aa, Aa, Aa, Aa^Fma, Gd, Ha^Fpa, Ha^Fpa, Aa^Fpa, Gd, Aa, Gd, Gd, Wwf, Ss, Ss, Aa, Aa, Aa^Fpa, Aa^Fpa, Aa^Fpa, Gd, Aa^Fpa, Cud, Cud, Cud, Cud, Cud, Ha, Ha, Ha, Ai, Ai, Ha, Ha, Ha
Xuce, Xuce, Xuce, Xuce, Xuce, Xuce, Xuce, Xuce, Xuce, Xuce, Xuce, Gd, Gd, Aa, Aa, Aa, Aa^Fma, Ha, Aa, Ha, Ha^Fpa, Aa^Fpa, Aa, Gd^Vo, Aa, Aa, Gd, Aa^Fma, Aa, Sm, Ai, Ai, Aa, Ha^Fpa, Ha^Fpa, Ha^Fma, Ha^Fma, Aa^Fma, Aa^Fma, Ha^Fpa, Ha, Ha^Fpa, Aa, Aa, Aa, Aa, Aa, Aa, Aa, Ss, Sm, Aa, Gd, Aa^Fpa, Aa^Fpa, Aa^Fpa, Aa^Fpa, Cud, Cud, 6 Kud, Cud, Cud, Ms, Ha, Ms, Ms, Ai, Ha, Ms, Ms
Xuce, Xuce, Xuce, Xuce, Xuce, Xuce, Xuce, Xuce, Xuce, Xuce, Xuce, Gd, Gd, Gd^Fpa, Aa, Aa, Aa, Aa, Gd, Gd, Aa^Fpa, Ha^Fpa, Gd, Gd, Gd, Aa, Aa^Fma, Aa, Aa^Fma, Aa, Sm, Aa, Aa, Aa, Ss, Gd, Aa^Fpa, Aa^Fpa, Aa^Fma, Ha^Fma, Aa, Ha^Fpa, Aa, Aa, Aa, Gd, Gd, Aa, Ss, Ss, Wwf, Aa, Gd, Gd, Gd, Gd, Gd, Ha, Ha, Cud, Ha, Ha, Ms, Ms, Ms^Xm, Ms^Xm, Ms^Xm, Ms^Xm, Ms^Xm, Ms^Xm
Xuce, Xuce, Xuce, Xuce, Xuce, Xuce, Xuce, Xuce, Xuce, Xuce, Xuce, Ai, Aa, Aa, Aa, Aa, Aa^Fpa, Aa, Gd, Aa^Fpa, Aa^Fpa, Aa^Fpa, Gd, Gd, Aa^Fma, Aa, Ha^Fma, Gd^Fma, Ha^Fma, Ha, Gd, Sm, Ai, Aa^Fma, Ai, Sm, Aa^Fpa, Aa^Fpa, Gd, Aa, Aa, Aa, Gd, Gd, Aa, Gd^Vha, Aa, Aa, Ai, Sm, Wwf, Wwf, Gd, Ai, Ss, Gd, Ha, Ha, Ha^Fma, Ha^Fma, Ms, Ms, Ms, Ms, Ms^Xm, Ms^Xm, Ms^Xm, Ms^Xm, Ms^Xm, Ms^Xm
Xuce, Xuce, Xuce, Xuce, Xuce, Xuce, Xuce, Xuce, Xuce, Xuce, Xuce, Aa, Aa, Aa, Aa^Fpa, Aa^Fpa, Gd, Gd, Gd, Gd, Gd, Gd, Gd, Aa^Fma, Ha^Fma, Ha^Fma, Ha^Fma, Gd^Fma, Ha, Ha, Ha, Gd, Sm, Wwf, Wwf, Ss, Ss, Gd, Gd, Aa, Aa, Aa, Aa, Aa, Aa, Ha, Aa, Ss, Gd, Ai, Gd, Gd, Aa, Ai, Ha, Ha, Ha, Ha^Fma, Aa^Vha, Ha, Ms, Ms, Ms^Xm, Ms^Xm, Ms^Xm, Ms^Xm, Ms^Xm, Ms^Xm, Ms^Xm, Ms^Xm
Xuce, Xuce, Xuce, Xuce, Xuce, Xuce, Xuce, Xuce, Xuce, Xuce, Xuce, Aa^Fpa, Aa^Fpa, Gd, Gd^Fpa, Gd, Gd, Gd, Gd, Gd, Ha, Ha, Gd, Gd, Cud, Ha^Fma, Aa, Aa^Fma, Ai, Ha, Ha, Gd, Gd, Wwf, Wwf, Ss, Gd, Aa, Gd, Aa, Gd, Gd, Aa, Ha, Ha, Ha^Fma, Aa^Fma, Aa^Fma, Gd, Gd, Aa, Aa, Gd, Aa, Ha, Ha, Ha^Fpa, Ha^Fma, Aa^Fpa, Ha, Ha, Ms^Xm, Ms, Ms^Xm, Ms^Xm, Ms^Xm, Ms^Xm, Ms^Xm, Ms^Xm, Ms^Xm
Xuce, Xuce, Xuce, Xuce, Xuce, Xuce, Xuce, Xuce, Xuce, Xuce, Xuce, Xuce, Gd, Gd^Fpa, Aa, Gd, Gd, Gd, Ha, Ha^Fma, Ha, Ha, Gd, Cud, Cud, Cud, 7 Kud, Cud, Cud, Cud, Ha, Ha, Gd, Gd, Gd, Gd, Gd, Gd, Gd, Gd, Gd, Gd, Aa, Gd, Aa^Fma, Aa^Fma, Gd, Gd, Gd, Gd, Gd, Aa, Gd, Aa, Aa, Ha^Fpa, Ha, Ha, Aa^Fpa, Ha^Fpa, Ha, Ms, Ms, Ms, Ms^Xm, Ms^Xm, Ms^Xm, Ms^Xm, Ms^Xm, Ms^Xm
Xuce, Xuce, Xuce, Xuce, Xuce, Xuce, Xuce, Xuce, Xuce, Xuce, Xuce, Xuce, Xuce, Aa, Xuce, Gd, Gd, Gd, Gd^Fma, Ha^Fma, Gd, Aa^Voa, Aa, Aa, Aa, Cud, Ai, Cud, Aa, Cud, Aa^Fpa, Gd, Aa^Fpa, Gd, Gd, Gd, Gd, Gd, Gd, Gd, Gd, Gd, Gd, Gd, Sm, Gd, Aa, Aa, Cud, Gd, Cud, Gd, Gd, Gd, Gd, Ha, Ha, Ha, Ha^Fpa, Ha, Ha, Ms, Ms, Ms, Ms, Ms^Xm, Ms^Xm, Ms^Xm, Ms^Xm, Ms^Xm
Xuce, Xuce, Xuce, Xuce, Xuce, Xuce, Xuce, Xuce, Xuce, Xuce, Xuce, Xuce, Xuce, Xuce, Xuce, Gd, Xuce, Gd, Xuce, Gd, Gd, Gd, Aa, Aa, Gd, Gd, Ai, Aa, Aa^Fpa, Aa^Fpa, Aa, Aa^Fpa, Aa^Fpa, Gd, Ha, Ha, Ha, Ha, Ha, Gd, Ha^Voa, Gd, Sm, Sm, Sm, Cud, Cud, Cud, 5 Kud, Cud, Cud, Cud, Cud, Gd, Gd, Gd, Gd, Ha, Ha^Fpa, Ha, Ms, Ms, Ms, Ms, Ms, Ms, Ms, Ms^Xm, Ms, Ms^Xm
Xuce, Xuce, Xuce, Xuce, Xuce, Xuce, Xuce, Xuce, Xuce, Xuce, Xuce, Xuce, Xuce, Xuce, Xuce, Xuce, Xuce, Xuce, Xuce, Xuce, Aa, Aa, Ha, Gd, Aa, Gd, Ai, Ai, Gd, Aa^Fpa, Gd, Aa, Aa, Ha, Aa, Aa, Ha^Fpa, Ha, Aa, Aa, Aa, Aa, Ai, Wwf, Gd, Cud, Gd, Cud, Aa, Cud, Aa, Cud, Gd, Gd, Gd, Gd, Gd, Gd, Aa, Ha, Ha^Fpa, Ai, Ms, Ms, Ms, Ms, Ms, Ms, Ms, Ms
Xuce, Xuce, Xuce, Xuce, Xuce, Xuce, Xuce, Xuce, Xuce, Xuce, Xuce, Xuce, Xuce, Xuce, Ms^Xm, Xuce, Xuce, Xuce, Ha, Ha, Ha^Fpa, Ha^Fpa, Ha, Ha, Aa, Aa, Ai, Gd, Aa, Aa, Ha^Voa, Ha, Ha, Aa, Ha^Fma, Ha^Fma, Ha^Fpa, Ha, Ha, Ha^Fma, Ha^Fma, Ha, Ha, Ai, Gd, Gd, Gd, Aa, Aa, Gd, Aa, Aa, Gd, Gd, Gd, Gd, Ha, Aa, Ha, Aa, Aa^Fpa, Ai, Ai, Ms, Ms, Ms, Ms, Ms, Ms, Ms
Xuce, Xuce, Xuce, Xuce, Xuce, Xuce, Xuce, Xuce, Xuce, Xuce, Xuce, Xuce, Ms^Xm, Ms^Xm, Ms^Xm, Ms^Xm, Ms^Xm, Xuce, Ha^Fpa, Ha^Fpa, Ha^Fpa, Ha^Fpa, Ha^Fpa, Aa, Ha^Fma, Ha, Gd, Ai, Gd, Aa, Ha^Fpa, Aa^Fma, Ha^Fma, Ha^Fma, Ha, Ha^Fma, Ms, Ms, Ms, Ha, Ha^Fma, Ha^Fma, Ha, Aa, Gd, Aa, Gd, Aa, Aa, Aa, Gd, Gd, Gd, Aa, Ha, Ha, Ha, Ha, Ha, Ha^Vha, Ha, Aa^Fpa, Ha, Ai, Ms, Ms, Ms, Ms, Ms, Ms
Xuce, Xuce, Xuce, Xuce, Xuce, Xuce, Xuce, Xuce, Xuce, Xuce, Ms^Xm, Xuce, Ms^Xm, Ms^Xm, Ms^Xm, Ms^Xm, Ms^Xm, Ms^Fpa, Ms^Fpa, Ha^Fpa, Ha, Ha^Fpa, Ms, Ha, Ha^Fma, Ha, Aa, Ai, Ha, Ha^Fpa, Ha, Aa^Fpa, Ms, Ha, Ms, Ms, Ms, Ms, Ms, Ha, Ha^Fma, Ha, Ha, Aa, Aa, Gd^Fpa, Aa^Fpa, Aa, Aa, Gd^Vha, Gd, Gd, Ha, Ha, Ha^Fma, Ha, Ms, Ms, Ms, Ha, Ms, Ha^Fpa, Ha, Ai, Ms, Ms, Ms, Ms, Ms^Xm, Aa
Xuce, Xuce, Xuce, Xuce, Xuce, Xuce, Xuce, Xuce, Xuce, Ms^Xm, Ms^Xm, Ms^Xm, Ms^Xm, Ms^Xm, Ai, Ms^Xm, Ms^Xm, Ms^Fpa, Ms^Xm, Ms^Xm, Ms, Ms, Ms, Ha, Ha, Ha^Fpa, Ai, Ai, Ha, Ha^Fpa, Ha, Ms, Ms, Ms, Ms^Xm, Ms^Xm, Ms^Xm, Ms^Xm, Ms^Xm, Ha, Ha^Fpa, Ha^Fpa, Aa, Aa, Gd, Aa^Fpa, Aa, Aa^Fpa, Gd^Fpa, Aa^Fpa, Gd, Ha, Ha^Fma, Ha^Fma, Ha, Ha, Ms, Ms, Ms, Ms, Ms, Ms, Ms, Ai, Ai, Ms, Ms, Ms^Xm, Ms^Xm, Ms^Xm
Xuce, Xuce, Xuce, Xuce, Xuce, Xuce, Xuce, Xuce, Xuce, Ms^Xm, Ms^Xm, Ms^Xm, Ms^Xm, Ai, Ai, Ai, Ms^Xm, Ms^Xm, Ms^Xm, Ms^Xm, Ms, Ms, Ms, Ms, Ms, Ai, Ai, Ai, Aa, Ha^Fpa, Ha, Ms, Ms, Ms, Ms^Xm, Ms^Xm, Ms^Xm, Ms^Xm, Ms^Xm, Ms, Ms, Ha^Fpa, Ha, Aa, Aa, Aa^Fpa, Aa^Fpa, Gd^Fpa, Gd, Aa, Aa, Ha, Ha, Ha, Ha, Ha, Ms, Ms, Ms^Xm, Ms, Ms, Ms, Ms, Ms, Ms, Ai, Ai, Ms^Xm, Ms^Xm, Ms^Xm
Xuce, Xuce, Xuce, Xuce, Xuce, Xuce, Xuce, Xuce, Xuce, Ms^Xm, Ms^Xm, Ms^Xm, Ms^Xm, Ms^Xm, Ms^Xm, Ms^Xm, Ms^Xm, Ms^Xm, Ms^Xm, Ms^Xm, Ms, Ms, Ms, Ms, Ms, Ms, Ai, Ai, Ai, Ha, Ha, Ms, Ms, Ms, Ms^Xm, Ms^Xm, Ms^Xm, Ms^Xm, Ms^Xm, Ms, Ms, Ms, Ha, Ha, Aa, Aa^Fpa, Aa, Aa, Gd, Gd, Aa, Ha, Ha, Ha, Ms, Ms^Xm, Ms^Xm, Ms^Xm, Ms^Xm, Ms^Xm, Ms^Xm, Ms^Xm, Ms^Xm, Ms, Ms^Xm, Ms^Xm, Ms^Xm, Ms^Xm, Ms^Xm, Ms^Xm
Xuce, Xuce, Xuce, Xuce, Xuce, Xuce, Xuce, Xuce, Xuce, Xuce, Xuce, Ms^Xm, Ms^Xm, Ms^Xm, Ms^Xm, Ms^Xm, Ms^Xm, Ms^Xm, Ms^Xm, Ms^Xm, Ms, Ms, Ms, Ms, Ms, Ai, Ai, Ai, Aa, Ha, Ms, Ms, Ms, Ms, Ms^Xm, Ms^Xm, Ms^Xm, Ms^Xm, Ms^Xm, Ms^Xm, Ms^Xm, Ms^Xm, Ms^Xm, Ha, Gd, Aa, Aa, Aa, Gd, Aa, Aa, Ai, Ms, Ms, Ms, Ms^Xm, Ms^Xm, Ms^Xm, Ms^Xm, Ms^Xm, Ms^Xm, Ms^Xm, Ms^Xm, Ms^Xm, Ms^Xm, Ms^Xm, Ms^Xm, Ms^Xm, Ms^Xm, Gd
