border_size=1
usage=map

Xu, Xu, Xu, Xu, Xu, Xu, Xu, Xu, Xu, Xu, Xu, Xu, Xu, Xu, Xu, Xu, Xu, Gd, Ms^Xm, Ms^Xm, Ms^Xm, Ms^Xm, Ms^Xm, Ms^Xm, Ms^Xm, Ms^Xm, Ms, Ms, Ms, Ms, Ha, Ha, Ha^Fpa, Gd, Aa, Aa, Ha, Aa, Aa^Fma, Ha^Fma, Ha, Ha, Ha^Fma, Ms^Xm, Ms^Xm, Gd, Ms, Ms, Ms, Ms, Ms^Xm, Ms, Ms, Ms, Ms, Ms^Xm, Ms^Xm, Ms^Xm, Ms^Xm, Gd, Ms^Xm, Gd, Ms^Xm, Ms^Xm, Ms^Xm, Ms, Ms, Ms, Ms, Ms
Xu, Xu, Xu, Xu, Xu, Xu, Xu, Xu, Xu, Xu, Xu, Xu, Xu, Xu, Xu, Xu, Ms^Xm, Ms^Xm, Ms^Xm, Ms^Xm, Ms^Xm, Ms^Xm, Ms, Ms^Xm, Ms^Xm, Ms^Xm, Ms, Ms, Ms, Ms, Ha, Ha, Ha, Aa, Aa, Aa, Aa, Ha, Aa, Ha^Fma, Ha^Fma, Ha^Fma, Ha^Fma, Ha, Ms^Xm, Ms^Xm, Ms^Xm, Ms, Ms, Ms, Ms, Ms^Xm, Ms^Xm, Ms^Xm, Ms, Ms^Xm, Ms^Xm, Ms^Xm, Ai, Ms^Xm, Ms^Xm, Ms^Xm, Ms^Xm, Ms^Xm, Ms^Xm, Ms, Ms, Ms, Ha, Ha
Xu, Xu, Xu, Xu, Xu, Xu, Xu, Xu, Xu, Xu, Xu, Xu, Xu, Xu, Xu, Xu, Ms^Xm, Ms^Xm, Ms^Xm, Ms^Xm, Ms, Ms, Ms, Ms, Ms, Ms^Xm, Ms^Xm, Ms, Ms, Ms, Ha, Ha^Fpa, Ha^Fpa, Ha^Vha, Gd, Gd, Aa, Ha, Aa, Aa, Aa, Ha^Fma, Ha^Fma, Ha, Ha, Ms^Xm, Ms^Xm, Ms^Xm, Ms^Xm, Ms, Ha, Ms, Ms, Ms^Xm, Ms, Ms^Xm, Ms, Ai, Ms^Xm, Ms^Xm, Ms^Xm, Ms^Xm, Ms^Xm, Ms^Xm, Ms, Ms^Xm, Ms^Xm, Ms, Ha^Fpa, Ha^Fpa
Xu, Xu, Xu, Xu, Xu, Xu, Xu, Xu, Xu, Xu, Xu, Xu, Xuce, Xu, Xu, Xu, Xu, Ms^Xm, Ms^Xm, Ms^Xm, Ms, Ms, Ms, Ms, Ms, Ms, Ms, Ms, Ms, Ms, Ms, Ha, Ha^Fpa, Ha^Fpa, Ha, Gd, Gd, Aa, Aa, Gd, Aa, Aa^Fma, Ha^Fma, Ha, Ha, Ms^Xm, Ms^Xm, Ms^Xm, Ha, Ha^Fpa, Ha^Fpa, Ha, Ha, Ms, Ms, Ms, Ai, Ai, Ms, Ms^Xm, Ms, Ms^Xm, Ms^Xm, Ms, Ms, Ms, Ms^Xm, Ms^Xm, Ha^Fpa, Ha^Fpa
Xu, Xu, Xu, Xu, Xu, Xu, Xu, Xu, Xu, Xu, Xu, Xu, Xuce, Xu, Xu, Xu, Xu, Xu, Ms^Xm, Ms, Ha, Ha, Ha, Ms, Ms, Ms, Ms, Ms, Ms, Ms, Ms, Ha, Ha, Ha^Fpa, Ha^Fpa, Gd, Aa, Aa, Aa, Gd, Aa, Ha, Ha^Vha, Ha^Fma, Ha, Ms^Xm, Ms^Xm, Ms, Ms^Xm, Ha, Ha^Fma, Ha^Fpa, Ha, Ms, Ai, Ai, Ms, Ms, Ms, Ms, Ms, Ms, Ms, Ms, Ms, Ms, Ms^Xm, Ha, Ha^Fpa, Ha^Fpa
Xu, Xu, Xu, Xu, Xu, Xu, Xuce, Xu, Xu, Xu, Xu, Xu, Xuce, Xu, Xu, Xu, Xu, Xu, Xu, Ms, Ha, Ha^Fpa, Ha^Fma, Ha, Ms, Ms, Ms, Ms, Ms^Xm, Ms, Ms, Ms, Ha, Ha^Fpa, Ai, Ha, Gd, Gd, Gd, Aa, Aa, Aa, Ha, Ha, Ha, Ms, Ms^Xm, Ms^Xm, Ms, Ha, Aa^Fpa, Ha, Ai, Ai, Ha, Ha^Vha, Aa, Ms, Ms, Ms, Ms, Ms, Ms, Ms, Ms, Ms, Ha, Aa, Ha^Fpa, Ha
Xu, Xu, Xuce, Xu, Xu, Xu, Xu, Xu, Xu, Xu, Xu, Xu, Xu, Xu, Xu, Xu, Xu, Xu, Xu, Ms, Aa, Ha, Aa^Fma, Ha^Fma, Ha, Ms, Ha, Ms, Ha, Ha, Ha, Ha, Cha, Ai, 2 Kha, Cha, Cha, Gd, Aa, Aa, Aa, Ha, Aa, Aa, Ha, Ha, Ha, Ha, Ha, Ha^Fpa, Aa^Fpa, Ai, Ha, Ha^Fpa, Aa, Aa, Ha, Ha, Ha, Ha^Fpa, Ha^Fma, Ms, Ms, Ms, Ms, Ha, Ha^Fpa, Ha^Fpa, Aa^Fpa, Aa
Xuce, Xuce, Xuce, Xuce, Xuce, Xu, Xu, Xu, Xu, Xu, Xu, Xu, Xu, Xu, Xu, Xu, Xu, Xu, Xu, Ms, Aa, Aa, Aa, Aa^Fpa, Ha^Fpa, Ha, Ha, Ha, Aa, Ha, Aa, Ha, Cha, Cha, Cha, Cha, Cha, Cha, Gd, Aa, Ai, Aa, Ha, Aa, Aa, Ha, Aa, Ha, Ha, Ms, Ai, Ww, Ha, Aa, Cha, Aa^Fma, Cha, Cha, Cha, Ha, Ha^Fpa, Ha^Fma, Ha^Fpa, Ms, Aa, Aa, Ha^Fma, Aa^Fma, Ha, Ha
Xuce, Xuce, Xuce, Xuce, Xuce, Xu, Xu, Xu, Xu, Xuce, Xu, Xu, Xu, Xu, Xu, Xu, Xu, Xu, Xu, Xu, Aa, Aa, Aa^Fpa, Ha, Ha, Ha^Fpa, Ha^Fma, Ha^Fma, Ha^Vha, Aa, Ha, Aa, Aa, Cha, Ai, Cha, Ss, Ha, Ha, Sm, Ss, Wwf, Ss, Ha, Ha, Aa, Aa, Aa, Aa, Ai, Ww, Ai, Cha, Cha, Cha, 3 Kha, Cha, Cha, Cha, Ha, Ha, Ha^Fma, Ha^Fma, Ha^Fma, Ha^Fpa, Ha^Fma, Ha^Fpa, Aa, Gd, Gd
Xuce, Xuce, Xuce, Xuce, Xu, Xu, Xu, Xu, Xu, Xu, Xu, Xu, Xu, Xu, Xu, Xu, Xu, Xu, Xu, Xu, Aa, Aa^Fma, Gd, Gd, Aa, Ha, Aa^Fpa, Ha^Fpa, Aa, Ss, Gd, Gd, Aa, Sm, Aa, Ai, Ha, Ha, Ss, Sm, Gd, Gd, Aa, Aa, Ai, Ai, Aa, Aa^Vha, Gd, Ai, Ww, Ai, Aa, Cha, Gd, Cha, Gd, Cha, Gd, Ha, Gd, Ha, Ha, Ha^Vha, Ha, Ha^Fpa, Aa, Aa, Gd, Gd
Xuce, Xuce, Xuce, Xuce, Xuce, Xuce, Xuce, Xuce, Xu, Xu, Xuce, Xuce, Xuce, Xuce, Xu, Xu, Xuce, Xu, Gd, Gd, Aa^Fpa, Aa, Aa, Aa, Aa, Aa, Gd^Fp, Aa^Fma, Aa^Fma, Aa^Fma, Ss, Ai, Sm, Ai, Sm, Ss, Ss, Ai, Sm, Ha, Ha^Fpa, Aa^Fpa, Sm, Aa, Gd, Gd, Ai, Aa, Gd, Gd, Aa, Aa, Gd, Gd, Aa, Gd, Aa, Gd, Aa, Aa, Gd, Ha, Ha, Ha, Ha, Aa, Aa, Aa, Gd, Gd
Xu, Xuce, Xuce, Xuce, Xuce, Xuce, Xu, Xu, Xu, Xuce, Xuce, Xuce, Xuce, Xuce, Xu, Xuce, Xuce, Xuce, Ai, Aa, Aa, Aa^Fpa, Gd, Aa, Aa, Aa, Gd, Gd^Fp, Gd, Hhd, Aa, Aa^Fma, Ss, Ai, Aa^Fpa, Gd^Fp, Sm, Sm, Aa, Ha, Aa^Fpa, Ha, Gd, Wwf, Ss, Aa, Sm, Ww, Sm, Gd, Gd, Aa, Gd, Aa, Aa, Ss, Sm, Aa, Gd, Aa, Gd, Gd, Gd, Aa, Aa, Gd, Ha, Ha, Aa, Ms
Xu, Xu, Xu, Xu, Xu, Xuce, Xuce, Xu, Xu, Xuce, Xuce, Xuce, Xuce, Xuce, Xu, Xuce, Xuce, Xuce, Ai, Aa, Aa^Fpa, Aa, Aa, Gd^Fp, Gd, Ha, Ms, Aa, Ha^Fpa, Aa^Fma, Ms, Aa^Fma, Aa, Ai, Gd, Aa, Gd^Fp, Gd^Fp, Gd, Aa, Sm, Ai, Wwf, Ai, Sm, Sm, Aa, Sm, Sm, Aa, Sm, Sm, Wwf, Aa, Wwf, Wwf, Wwf, Sm, Aa, Gd, Aa, Gd, Aa^Fpa, Aa, Ha^Fma, Aa^Fma, Aa, Ha, Ha, Ha
Xu, Xu, Xu, Xu, Xu, Xu, Xu, Xu, Xu, Xu, Xu, Xuce, Xuce, Xu, Xuce, Xu, Xuce, Ai, Aa^Fpa, Aa^Fpa, Aa^Fpa, Aa^Voa, Aa, Gd, Aa, Aa, Ha, Ha, Ha^Fpa, Ms, Ms, Ms, Ha, Ai, Ai, Aa, Ss, Gd, Sm, Gd, Aa, Gd, Aa, Ww, Ai, Gd, Aa, Gd, Sm, Sm, Ai, Aa, Ha, Aa, Ha^Fpa, Ai, Aa, Aa, Aa, Aa, Aa, Aa^Fma, Ha, Ha, Aa, Ha^Fma, Aa, Aa, Ha, Ha
Xu, Xu, Xu, Xu, Xu, Xu, Xu, Xu, Xu, Xu, Xu, Xu, Xu, Xu, Gd, Xuce, Aa, Gd, Gd, Ha, Aa^Fpa, Gd, Hhd, Hhd, Gd, Ha, Wwf, Aa, Gd, Ha, Aa, Ms, Ms, Ai, Aa, Gd, Wwf, Sm, Gd, Gd, Ha^Fma, Ww, Ai, Aa, Ai, Ww, Aa, Aa, Ai, Wwf, Wwf, Ai, Gd, Ha, Gd^Fp, Aa^Fma, Aa^Fpa, Wwf, Gd, Gd, Gd, Aa, Gd, Gd, Cha, Ha, Cha, Ha, Ms, Ms
Xu, Xu, Xu, Xu, Xu, Xu, Xu, Xu, Xu, Xu, Xu, Xu, Xu, Xu, Gd, Gd, Aa, Aa, Aa, Aa, Aa, Aa, Aa, Aa, Sm, Ai, Aa, Wwf, Wwf, Gd, Aa^Voa, Ha, Ms, Ms, Ss, Gd, Sm, Wwf, Ai, Ai, Aa^Fma, Aa, Ai, Ww, Aa^Fma, Ww, Ha, Gd, Ai, Wwf, Sm, Sm, Wwf, Gd, Gd, Wwf, Gd, Gd, Gd, Ha^Vha, Aa, Gd, Cha, Cha, 4 Kha, Cha, Cha, Ha, Ms^Xm, Ms^Xm
Xu, Xu, Xu, Xu, Xu, Xu, Xu, Xu, Xu, Xu, Xu, Xu, Xu, Xu, Gd, Ha, Aa^Fma, Aa, Aa, Aa, Gd^Fp, Gd^Fp, Gd, Sm, Ha, Gd^Fp, Ai, Ai, Ss, Gd, Gd, Gd, Ha, Ha, Ms, Sm, Aa, Aa, Sm, Ss, Gd, Gd^Vhr, Wwf, Aa, Gd, Ha, Gd, Gd^Fp, Aa, Aa^Fma, Gd^Fp, Gd, Wwf, Ss, Ai, Ss, Ai, Gd, Ai, Ha, Ha^Fpa, Aa, Cha, Cha, Cha, Cha, Ms, Ms, Ms, Ms^Xm
Xu, Xu, Xu, Xu, Xu, Xu, Xu, Xu, Xu, Xu, Xu, Xu, Xu, Xu, Gd, Ha^Vct, Gd, Gd, Aa, Aa, Aa, Gd, Gd, Aa, Ha, Ha, Wwf, Ss, Ss, Sm, Sm, Gd, Sm, Sm, Aa^Fpa, Aa^Fpa, Aa^Fpa, Aa, Ww, Wwf, Ai, Ai, Ss, Wwf, Sm, Gd, Gd, Aa, Wwf, Gd, Gd, Aa^Fma, Gd, Ss, Wwf, Ai, Gd, Ww, Ai, Ha, Ha, Ha, Ha^Fpa, Ha, Ms, Ms, Ms, Ms, Ms, Ms^Xm
Xu, Xu, Xu, Xu, Xu, Xu, Xu, Xu, Xuce, Xuce, Xuce, Xuce, Xu, Aa^Fma, Gd, Gd, Aa, Gd, Cea, Aa, Gd, Aa, Hhd, Aa, Gd^Fp, Gd^Fp, Gd, Gd^Fp, Gd^Fp, Sm, Gd, Wwf, Sm, Aa^Fpa, Sm, Ha, Ww, Sm, Aa^Fpa, Wwf, Ai, Ww, Ai, Sm, Ss, Sm, Sm, Wwf, Ha^Fma, Ai, Aa^Fma, Gd, Aa, Aa, Ai, Ai, Ai, Ai, Ai, Ha, Ai, Ha^Fpa, Aa, Ha, Ha, Ms, Ms, Ms, Ms, Ms^Xm
Xu, Xu, Xu, Xu, Xu, Xu, Xu, Xu, Xu, Xuce, Xuce, Xuce, Xuce, Gd, Gd, Gd, Cea, Cea, Cea, Gd, Gd^Vct, Hhd, Gd, Hhd, Gd, Gd^Fp, Gd^Fp, Ha^Fpa, Wwf, Ai, Gd, Ha, Ha^Fpa, Aa, Ss, Ha, Ha, Gd, Wwf, Gd, Ai, Aa, Ai, Sm, Ai, Ai, Ww, Ww, Wwf, Ww, Aa, Ai, Ww, Gd^Vhr, Ww, Aa, Ai, Ai, Aa^Fpa, Ai, Aa^Fpa, Ha^Fpa, Ha^Fpa, Aa, Aa, Ha, Ha, Ms, Ms, Ms^Xm
Xu, Xu, Xu, Xu, Xu, Xu, Xu, Xu, Xu, Xuce, Xuce, Xuce, Gd, Gd^Vct, Gd, Gd, 1 Kea, Cea, Cea, Gd, Gd, Gd, Wwf, Gd, Gd, Ha, Aa, Ai, Wwf, Wwf, Aa, Gd, Hhd, Ss, Aa, Aa, Ai, Aa^Fpa, Ww, Ww, Aa, Ww, Wwf, Ww, Ww, Aa^Fpa, Wo, Ai, Wo, Wo, Wo, Ai, Wo, Wwf, Aa, Aa, Wo, Ww, Ww, Ai, Ai, Aa, Aa^Fpa, Ha, Ha^Fpa, Aa, Ha, Ms, Ms, Ms
Xu, Xu, Xu, Xu, Xu, Xu, Xu, Xu, Xuce, Xuce, Xuce, Xuce, Gd, Gd, Sm, Cea, Cea, Cea, Wwf, Aa, Wwf, Gd, Gd, Ai, Aa, Gd, Gd, Gd, Aa, Gd, Gd, Aa^Vha, Aa, Ss, Ss, Ai, Ss, Wwf, Ai, Ai, Ww, Ww, Wwf, Ai, Ai, Ai, Ss, Wo, Wwf, Aa, Ww, Wwf, Aa^Fma, Wo, Wo, Wo, Wwf, Aa, Wo, Ha, Ai, Ha, Ha, Aa^Fpa, Ha^Fpa, Ha, Ha, Ha, Ha, Ms
Wwf, Xu, Uu^Uf, Uh^Dr, Uu^Uf, Xu, Aa, Xu, Wwf, Aa, Wwf, Aa, Aa, Aa, Aa, Sm, Aa, Gd, Gd, Gd, Gd, Ww, Gd, Gd, Hhd, Aa^Fma, Hhd, Gd, Gd, Aa, Aa, Aa^Fpa, Ha^Fpa, Aa, Sm, Ss, Ww, Wwf, Ww, Gd, Ai, Wwf, Ai, Ss, Gd, Wwf, Wwf, Ww, Gd, Ai, Ai, Ww, Ww, Ww, Wwf, Ww, Ww, Wwf, Aa^Fma, Ai, Ww, Ww, Ww, Aa, Aa, Ai, Ha^Fpa, Ha, Ha, Ha
Uh^Dr, Wwf^Dr, Wwf^Dr, Wwf^Dr, Wwf^Dr, Xu, Wwf^Qov, Wwf, Aa, Wwf, Aa, Aa, Ai, Aa, Wwf, Ai, Wwf, Aa, Gd, Gd, Aa, Gd, Gd, Hhd, Gd^Fp, Gd^Fp, Aa, Gd, Hhd, Aa, Ha^Fpa, Aa^Fpa, Ha, Ss, Sm, Aa, Aa^Fpa, Gd^Vhr, Ww, Gd, Ww, Aa, Sm, Sm, Ww, Wwf, Ww, Aa, Aa^Fpa, Ww, Ha^Fma, Ww, Ai, Ai, Ww, Ai, Ww, Ai, Ai, Ai, Ww, Aa^Fma, Wo, Ww, Ww, Wwf, Ww, Ai, Ha, Ai
Xuce, Uh^Dr, Uu^Uf, Xu, Uh^Dr, Wwf^Qov, Uh^Qov, Uu, Gd, Gd, Gd, Wwf, Wwf, Wwf, Ai, Wwf, Aa, Gd^Vct, Aa, Ha, Aa, Gd, Aa, Gd, Ss, Ss, Gd^Fp, Ss, Hhd, Ww, Ai, Wwf, Ss, Sm, Ss, Aa^Fpa, Sm, Aa^Fpa, Gd, Aa, Wwf, Ss, Sm, Ww, Wwf, Gd, Aa, Aa^Fpa, Aa^Fpa, Gd, Ww, Ss, Ww, Aa^Fpa, Ha^Fpa, Ww, Ai, Ai, Ai, Gd, Wwf, Ww, Ww, Ai, Wo, Ww, Ww, Ai, Ww, Ai
Xuce, Xuce, Xuce, Uh^Dr, Xuce, Ss, Xuce, Xuce, Xuce, Xuce, Xuce, Gd, Gd, Wwf, Ai, Aa, Aa, Aa, Aa, Aa, Ha, Gd, Ss, Ha, Ss, Aa, Aa, Ss, Aa^Voa, Aa, Ai, Ai, Ss, Ss, Aa, Sm, Aa^Fpa, Sm, Ww, Aa^Fpa, Aa, Gd, Wwf, Gd, Aa, Gd, Gd, Aa, Aa, Gd, Ww, Ai, Ai, Aa^Fpa, Aa^Fpa, Ai, Aa^Fpa, Gd, Gd, Aa, Aa, Ww, Ai, Ww, Ww, Wo, Wo, Ww, Wo, Wwf
Xuce, Xuce, Xuce, Xuce, Xuce, Xuce, Xuce, Xuce, Xuce, Xuce, Xuce, Gd, Wwf, Wwf, Aa, Gd, Aa^Fpa, Aa, Aa, Aa, Ms, Ha, Ai, Ss, Sm, Gd^Fp, Aa, Gd, Aa^Fma, Aa, Aa, Aa, Gd, Ss, Ss, Aa, Ha^Fpa, Ww, Aa^Fpa, Aa, Aa, Ww, Sm, Aa, Ww, Aa, Ww, Ww, Aa, Gd^Vhr, Gd, Gd, Ai, Aa, Ai, Aa, Aa^Fpa, Aa^Fpa, Gd, Aa, Ai, Ai, Ai, Wwf, Ai, Ww, Ai, Wo, Ww, Wo
Xuce, Xuce, Xuce, Xuce, Xuce, Xuce, Xuce, Xuce, Xuce, Xuce, Xuce, Gd, Gd, Wwf, Aa, Aa^Fpa, Ha^Fpa, Gd^Fp, Aa, Aa, Aa, Aa, Aa, Sm, Aa, Gd^Fp, Aa^Fma, Aa, Gd^Fp, Aa, Gd, Aa, Aa, Ha, Ss, Ss, Ha, Gd^Vhr, Gd, Ww, Sm, Wwf, Ww, Ww, Aa, Ss, Ss, Wwf, Sm, Gd, Gd, Ai, Aa, Ai, Gd, Aa, Gd, Wwf, Chr, Gd, Chr, Ha, Ha^Vha, Ai, Ai, Ha^Fpa, Ai, Ha^Fpa, Ha^Fpa, Ai
Xuce, Xuce, Xuce, Xuce, Xuce, Xuce, Xuce, Xuce, Xuce, Xuce, Gd, Gd, Gd, Aa, Aa, Aa, Gd^Fp, Ha^Fpa, Ha^Fpa, Gd, Ha^Fpa, Aa, Aa, Aa, Aa, Aa, Aa^Fma, Aa, Gd^Fp, Gd, Wwf, Wwf, Aa, Ss, Aa^Fma, Ss, Ss, Ss, Ww, Gd, Ha^Fpa, Ww, Ww, Ww, Aa, Gd, Ww, Wwf, Ss, Ss, Aa, Ai, Aa^Fpa, Aa^Fpa, Gd^Fp, Gd, Aa^Fpa, Chr, Chr, Chr, Chr, Ai, Ha, Ha, Ha, Ai, Ai, Ha, Ha, Ha
Xuce, Xuce, Xuce, Xuce, Xuce, Xuce, Xuce, Xuce, Xuce, Xuce, Gd, Gd, Gd, Aa, Aa, Aa, Aa^Fma, Ha, Sm, Ha, Ha^Fpa, Aa^Fpa, Aa, Gd^Vo, Aa, Aa, Gd, Aa^Fma, Aa, Sm, Ai, Ai, Aa, Ha^Fpa, Ha^Fpa, Ha^Fpa, Ha^Fma, Gd^Fp, Gd^Fp, Gd^Fp, Ha, Ha^Fpa, Aa, Aa, Aa, Ww, Ww, Aa, Aa, Ss, Sm, Aa, Aa, Aa^Fpa, Aa^Fpa, Aa^Fpa, Aa^Fpa, Chr, Chr, 7 Khr, Chr, Ha, Ms, Ha, Ms, Ms, Ai, Ha, Ms, Ms
Xuce, Xuce, Xuce, Xuce, Xuce, Xuce, Xuce, Xuce, Xuce, Gd, Gd, Gd, Gd, Aa^Fpa, Aa, Ss, Ss, Sm, Ss, Aa, Ss, Ha^Fpa, Gd, Gd, Gd, Aa, Aa^Fma, Aa, Aa^Fma, Aa, Sm, Aa, Aa, Aa, Ss, Aa, Aa^Fpa, Gd^Fp, Aa^Fma, Ha^Fma, Ww, Ha^Fpa, Ss, Ww, Ww, Gd, Gd, Ww, Ww, Ss, Wwf, Aa, Gd, Aa, Gd, Aa, Gd, Chr, Ha, Chr, Ha, Ha, Ms, Ms, Ms^Xm, Ms^Xm, Ms^Xm, Ms^Xm, Ms^Xm, Ms^Xm
Xuce, Xuce, Xuce, Xuce, Xuce, Xuce, Xuce, Xuce, Xuce, Gd, Ha, Gd, Aa, Aa, Aa, Aa, Aa^Fpa, Sm, Gd, Ss, Aa^Fpa, Gd^Fp, Gd, Gd, Aa^Fma, Aa, Ha^Fma, Aa^Fpa, Ha^Fma, Ha, Gd, Sm, Ai, Aa^Fma, Ai, Sm, Aa^Fpa, Aa^Fpa, Ww, Aa, Sm, Ww, Gd, Gd, Aa, Gd^Vhr, Aa, Ww, Ai, Sm, Ss, Wwf, Gd, Ai, Ss, Gd, Ha, Ha, Ha^Fma, Ha^Fma, Ms, Ms, Ms, Ms, Ms^Xm, Ms^Xm, Ms^Xm, Ms^Xm, Ms^Xm, Ms^Xm
Xuce, Xuce, Xuce, Xuce, Xuce, Xuce, Xuce, Xuce, Xuce, Ha, Gd, Gd, Ms, Aa, Aa^Fpa, Aa^Fpa, Gd, Aa, Gd, Aa, Gd, Gd, Gd, Aa^Fma, Ha^Fma, Ha^Fpa, Ha^Fma, Aa^Fma, Ha, Ha, Ha, Gd, Sm, Wwf, Wwf, Ss, Ss, Gd, Sm, Ww, Ww, Aa, Aa, Ww, Aa, Ha, Aa, Ss, Gd, Ai, Gd, Ss, Ss, Ss, Ha, Ha, Ha, Ha^Fma, Aa^Vha, Ha, Ms, Ms, Ms^Xm, Ms^Xm, Ms^Xm, Ms^Xm, Ms^Xm, Ms^Xm, Ms^Xm, Ms^Xm
Xuce, Xuce, Xuce, Xuce, Xuce, Xuce, Xuce, Xuce, Xuce, Ha, Ms, Gd, Ms, Gd, Aa^Fpa, Aa, Gd, Gd, Aa, Aa, Ha, Ha, Gd, Gd, Chr, Ha^Fma, Aa, Aa^Fma, Ai, Ha, Ha, Gd, Gd, Wwf, Wwf, Ss, Sm, Aa, Aa, Sm, Sm, Aa, Aa, Ha, Ha, Ha^Fma, Aa^Fma, Gd^Fp, Gd, Gd, Aa, Aa, Gd, Aa, Ha, Ha, Ha^Fpa, Ha^Fma, Aa^Fpa, Ha, Ha, Ms^Xm, Ms, Ms^Xm, Ms^Xm, Ms^Xm, Ms^Xm, Ms^Xm, Ms^Xm, Ms^Xm
Xuce, Xuce, Xuce, Xuce, Xuce, Xuce, Xuce, Xuce, Ha, Ha, Ha^Fma, Ha^Fma, Ha^Fma, Aa^Fpa, Ms, Gd, Gd, Aa, Ha, Ha^Fma, Ha, Ha, Gd, Chr, Chr, Chr, 5 Khr, Chr, Chr, Chr, Ha, Ha, Gd, Gd, Gd, Gd, Aa, Sm, Sm, Ww, Sm, Aa, Aa, Gd, Aa^Fma, Aa^Fma, Gd, Gd, Gd, Gd, Gd, Aa, Gd, Aa, Aa, Ha^Fpa, Ha, Ha, Aa^Fpa, Ha^Fpa, Ha, Ms, Ms, Ms, Ms^Xm, Ms^Xm, Ms^Xm, Ms^Xm, Ms^Xm, Ms^Xm
Xuce, Xuce, Xuce, Xuce, Xuce, Xuce, Xuce, Xuce, Ha, Aa, Ha, Aa, Ha^Fma, Ha^Fma, Gd, Ms^Xm, Gd, Aa, Aa^Fma, Ha^Fma, Aa, Aa^Voa, Aa, Aa, Aa, Chr, Ai, Chr, Aa, Chr, Aa^Fpa, Gd, Aa^Fpa, Gd, Aa, Aa, Aa, Ai, Sm, Aa, Aa, Sm, Gd, Gd, Sm, Gd, Aa, Aa, Chr, Gd, Chr, Gd, Gd, Gd, Aa, Ha, Ha, Ha, Ha^Fma, Ha, Ha, Ms, Ms, Ms, Ms, Ms^Xm, Ms^Xm, Ms^Xm, Ms^Xm, Ms^Xm
Xuce, Xuce, Xuce, Xuce, Xuce, Xuce, Xuce, Ms^Xm, Ms^Xm, Ha^Fma, Ha, Ha^Fma, Ha^Fma, Ha^Fma, Ms^Xm, Ms^Xm, Ms^Xm, Gd, Ms^Xm, Aa, Gd, Aa, Aa, Aa, Gd, Gd, Ai, Aa, Aa^Fpa, Aa^Fpa, Aa, Aa^Fpa, Aa^Fpa, Aa, Ha, Ha, Ha, Ha, Ha, Aa, Ha^Voa, Aa, Sm, Sm, Sm, Chr, Chr, Chr, 6 Khr, Chr, Chr, Chr, Chr, Gd, Gd, Aa, Aa, Ha, Ha^Fpa, Ha, Ms, Ms, Ms, Ms, Ms, Ms, Ms, Ms^Xm, Ms, Ms^Xm
Xuce, Xuce, Xuce, Xuce, Xuce, Xuce, Ms^Xm, Ms^Xm, Ha^Fma, Ha^Fma, Aa, Ha, Ha^Fma, Ms, Ms, Ms^Xm, Ms^Xm, Ms^Xm, Ms^Xm, Ms^Xm, Aa, Aa, Ha, Gd, Aa, Gd, Ai, Ai, Gd, Aa^Fpa, Gd, Aa, Aa, Ha, Aa, Aa, Ha^Fpa, Ha, Aa, Aa, Aa, Aa, Ai, Wwf, Gd, Chr, Gd, Chr, Aa, Chr, Aa, Chr, Gd, Gd, Gd, Aa, Aa, Ha, Aa, Ha, Ha^Fpa, Ai, Ms, Ms, Ms, Ms, Ms, Ms, Ms, Ms
Xuce, Xuce, Xuce, Xuce, Xuce, Ms, Ms, Ha^Fma, Ha^Fma, Ha^Fma, Ha, Ha^Fma, Ha^Fma, Ms^Xm, Ms, Ms^Xm, Ms^Xm, Ms^Xm, Ha, Ha, Ha^Fpa, Ha^Fpa, Ha, Ha, Aa, Aa, Ai, Gd, Aa, Aa, Ha^Voa, Ha, Ha, Aa, Ha^Fpa, Ha^Fpa, Ha^Fpa, Ha, Ha, Ha^Fma, Ha^Fpa, Ha, Ha, Ai, Gd, Gd, Gd, Aa, Aa, Gd, Aa, Aa, Gd, Gd, Gd, Gd, Ha, Aa, Ha, Aa, Aa^Fpa, Ai, Ai, Ms, Ms, Ms, Ms, Ms, Ms, Ms
Xuce, Xuce, Xuce, Xuce, Xuce, Ms^Xm, Ms, Ha^Fma, Ha^Fma, Ha, Ha^Fma, Ha^Fma, Ms, Ms, Ms^Xm, Ms, Ms^Xm, Ms^Xm, Ha^Fpa, Ha^Fpa, Ha^Fma, Ha^Fpa, Ha^Fpa, Aa, Ha^Fma, Ha, Gd, Ai, Gd, Aa, Ha^Fpa, Aa^Fma, Ha^Fma, Ha^Fma, Ha, Ha^Fma, Ms, Ms, Ms, Ha, Ha^Fma, Ha^Fma, Ha, Aa, Gd, Aa, Gd, Aa, Aa, Aa, Gd, Gd, Gd, Aa, Ha, Ha, Ha, Ha, Ha, Ha^Vha, Ha, Aa^Fpa, Ha, Ai, Ms, Ms, Ms, Ms, Ms, Ms
Xuce, Xuce, Xuce, Xuce, Ms, Ms, Ms^Xm, Ha^Fma, Ha^Fma, Aa, Ha^Fma, Ms, Ms, Ms, Ms^Xm, Ms^Xm, Ms^Xm, Ms^Fpa, Ms^Fpa, Ha^Fpa, Ha, Ha^Fpa, Ms, Ha, Ha^Fma, Ha, Aa, Ai, Ha, Ha^Fpa, Ha, Aa^Fpa, Ms, Ha, Ms, Ms, Ms, Ms, Ms, Ha, Ha^Fma, Ha, Ha, Aa, Aa, Aa^Fpa, Aa^Fpa, Aa, Aa, Gd^Vhr, Gd, Gd, Ha, Ha, Ha^Fma, Ha, Ms, Ms, Ms, Ha, Ms, Ha^Fpa, Ha, Ai, Ms, Ms, Ms, Ms, Ms^Xm, Aa
Xuce, Xuce, Xuce, Xuce, Ms, Ms, Ha^Fma, Ha^Fma, Ha, Ha^Fma, Ha^Fma, Ms, Ms^Xm, Ms^Xm, Ai, Ms^Xm, Ms^Xm, Ms^Fpa, Ms^Xm, Ms^Xm, Ms, Ms, Ms, Ha, Ha, Ha^Fpa, Ai, Ai, Ha, Ha^Fpa, Ha, Ms, Ms, Ms, Ms^Xm, Ms^Xm, Ms^Xm, Ms^Xm, Ms^Xm, Ha, Ha^Fpa, Ha^Fpa, Aa, Aa, Gd, Aa^Fpa, Aa^Fma, Aa^Fpa, Aa^Fpa, Aa^Fpa, Gd, Ha, Ha^Fma, Ha^Fma, Ha, Ha, Ms, Ms, Ms, Ms, Ms, Ms, Ms, Ai, Ai, Ms, Ms, Ms^Xm, Ms^Xm, Ms^Xm
Xuce, Xuce, Xuce, Xuce, Ms^Xm, Ms, Ha^Fma, Aa, Ha^Fma, Ha^Fma, Ms, Ms, Ms^Xm, Ai, Ai, Ai, Ms^Xm, Ms^Xm, Ms^Xm, Ms^Xm, Ms, Ms, Ms, Ms, Ms, Ai, Ai, Ai, Aa, Ha^Fpa, Ha, Ms, Ms, Ms, Ms^Xm, Ms^Xm, Ms^Xm, Ms^Xm, Ms^Xm, Ms, Ms, Ha^Fpa, Ha, Aa, Aa, Aa^Fpa, Aa^Fpa, Aa^Fpa, Gd, Aa, Aa, Ha, Ha, Ha, Ha, Ha, Ms, Ms, Ms^Xm, Ms, Ms, Ms, Ms, Ms, Ms, Ai, Ai, Ms^Xm, Ms^Xm, Ms^Xm
Xuce, Xuce, Xuce, Ms, Ms, Ms, Ha^Fma, Aa, Aa, Ha, Ha, Ms, Ms, Ms^Xm, Ms^Xm, Ms^Xm, Ms^Xm, Ms^Xm, Ms^Xm, Ms^Xm, Ms, Ms, Ms, Ms, Ms, Ms, Ai, Ai, Ai, Ha, Ha, Ms, Ms, Ms, Ms^Xm, Ms^Xm, Ms^Xm, Ms^Xm, Ms^Xm, Ms, Ms, Ms, Ha, Ha, Aa, Aa^Fpa, Aa, Aa^Fpa, Gd, Gd, Aa, Ha, Ha, Ha, Ms, Ms^Xm, Ms^Xm, Ms^Xm, Ms^Xm, Ms^Xm, Ms^Xm, Ms^Xm, Ms^Xm, Ms, Ms^Xm, Ms^Xm, Ms^Xm, Ms^Xm, Ms^Xm, Ms^Xm
Xuce, Xuce, Xuce, Xuce, Ms, Ms, Ms, Ha^Fma, Ms, Ms, Ha, Ms, Ms, Ms^Xm, Ms^Xm, Ms^Xm, Ms^Xm, Ms^Xm, Ms^Xm, Ms^Xm, Ms, Ms, Ms, Ms, Ms, Ai, Ai, Ai, Aa, Ha, Ms, Ms, Ms, Ms, Ms^Xm, Ms^Xm, Ms^Xm, Ms^Xm, Ms^Xm, Ms^Xm, Ms^Xm, Ms^Xm, Ms^Xm, Ha, Gd, Aa, Aa, Aa, Gd, Aa, Aa, Ai, Ms, Ms, Ms, Ms^Xm, Ms^Xm, Ms^Xm, Ms^Xm, Ms^Xm, Ms^Xm, Ms^Xm, Ms^Xm, Ms^Xm, Ms^Xm, Ms^Xm, Ms^Xm, Ms^Xm, Ms^Xm, Gd
