border_size=1
usage=map

Ms^Xm, Ms^Xm, Ms^Xm, Ms^Xm, Ms^Xm, Ms^Xm, Ms^Xm, Gs, Ms^Xm, Ms^Xm, Ms^Xm, Gs, Ms^Xm, Ms^Xm, Ha, Ha, Ha, Ms^Xm, Ha, Gs, Ha, Gs, Ms^Xm, Ms^Xm, Ha, Ha, Ha, Ha, Ha, Ha, Ha, Aa, Aa, Aa, Aa, Aa, Re, Re, Re, Aa, Aa, Aa, Ms, Ms^Xm, Ms^Xm, Ms^Xm
Ms^Xm, Ms^Xm, Ms^Xm, Ms^Xm, Ms^Xm, Ms^Xm, Ms^Xm, Ms^Xm, Ms^Xm, Ms^Xm, Ms^Xm, Ms^Xm, Ms^Xm, Ms^Xm, Ha, Ha, Ms^Xm, Ms^Xm, Ms^Xm, Ha, Ms^Xm, Ms^Xm, Ms^Xm, Ms^Xm, Ha, Ha, Ha, Ha, Ha, Ha, Aa, Aa, Aa, Aa, Gs, Re, Re, Re, Aa, Aa, Aa, Ms, Ms, Ms, Ms^Xm, Ms^Xm
Ms^Xm, Ms^Xm, Ms^Xm, Ms^Xm, Ms, Ms, Ms, Ms^Xm, Ms^Xm, Ms^Xm, Ms^Xm, Ms^Xm, Ms^Xm, Ms^Xm, Ms^Xm, Ms^Xm, Ha, Ms^Xm, Ms^Xm, Ms^Xm, Ms^Xm, Ms^Xm, Ms^Xm, Ms^Xm, Ha, Ha, Aa^Fpa, Aa, Aa^Fpa, Aa, Aa^Fma, Aa, Aa, Gs, Re, Re, 1 Re, Re, Re, Aa, Ms, Ms, Ms, Ms, Ms^Xm, Ms^Xm
Ms, Ms, Ms, Ms, Ms, Ms, Ms, Ms, Ms^Xm, Ms^Xm, Ms^Xm, Ms^Xm, Ms, Ms^Xm, Ms^Xm, Ms^Xm, Ms, Ms, Ms, Ms^Xm, Ms^Xm, Ms^Xm, Ms^Xm, Ms^Xm, Ha^Fma, Ha, Aa^Fma, Aa^Fpa, Aa, Aa, Aa, Aa, Gll^Fmw, Re, Re, Re, Re, Re, Aa^Fma, Aa, Ms, Ms, Ms, Ms, Ms^Xm, Ms^Xm
Ms, Ms, Ms, Ms, Ms, Ms, Ms, Ms, Ms, Ms, Ms, Ms, Ms, Ms, Ms, Ms, Ms, Ms, Ms, Ms^Xm, Ms^Xm, Ms^Xm, Ms^Xm, Ms^Xm, Ha^Fma, Ha, Aa, Aa, Aa, Aa, Gll^Fmw, Gll^Fmw, Re, Re, Re, Re, Gs, Aa, Ha^Fma, Ha^Fma, Ms, Ms, Ms, Ms^Xm, Ms^Xm, Ms^Xm
Ms, Ms, Ms, Ms, Ms, Ms, Ms, Ms, Ms, Ms, Ms, Ms, Ha, Ms, Ms, Ms, Ms, Ms, Ms^Xm, Ms^Xm, Ms^Xm, Ms^Xm, Ms^Xm, Ms^Xm, Ha, Ha, Gs, Gs, Aa, Gs, Re, Re, Re, Re, Re, Re, Ha, Ha, Aa^Fma, Aa, Aa^Fma, Aa, Ms, Ms^Xm, Ms^Xm, Ms^Xm
Ms, Ms, Ms, Ms, Ms, Ms, Ms, Ms, Ms^Xm, Ms, Ms, Ha, Ha^Fma, Ha^Fma, Ms, Ms, Ms, Ms, Ha, Ms^Xm, Ms, Ms^Xm, Ha, Ha, Ha, Gs, Gs, Aa, Gs, Re, Aa, Aa, Re, Re, Gll^Fmw, Gs, Aa, Ms, Ms, Aa^Fma, Aa, Aa, Ms, Ms, Aa^Fma, Ms^Xm
Ms, Ms, Ms^Xm, Ms, Ms, Ms, Ms^Xm, Ms^Xm, Ms^Xm, Ms^Xm, Ms^Xm, Ha, Ha, Ha, Ms, Ms, Ha^Fma, Ha, Ha^Fma, Ha, Ms, Ms, Ha, Ha^Fma, Gs, Gs, Gs, Gs, Gs, Re, Re, Re, Gll^Fmw, Gll^Fmw, Gs, Gs, Ha, Ha, Ms, Ms, Ms, Ms, Ms, Ms, Ms^Xm, Aa
Ha, Ms^Xm, Ms^Xm, Ms^Xm, Ms^Xm, Ms^Xm, Ms^Xm, Ms^Xm, Ms^Xm, Ms^Xm, Ha, Ms^Xm, Ms, Ms, Ms, Ha, Ha^Fma, Ha^Fma, Ha, Ha, Ms, Ms, Ha, Ha^Fma, Aa^Fma, Aa, Gs, Gs, Re, Re, Re, Re, Gs, Gll^Fmw, Gs, Ha, Ms, Ms, Ms, Ms, Ms, Ms, Ms^Xm, Ms^Xm, Ms^Xm, Ms^Xm
Ha, Ha, Ms^Xm, Ms^Xm, Ms^Xm, Ms^Xm, Ms^Xm, Ms^Xm, Ha^Fpa, Ha, Ha^Fpa, Ha^Fpa, Ms, Ms, Ms, Ha, Ha, Ha, Ms^Xm, Ms, Ms, Ha, Ha, Aa^Fma, Gll^Fmw, Gll^Fp, Aa, Aa, Re, Re, Re, Re, Aa, Aa, Ha, Ha, Ms, Ms, Ms, Ms, Ms, Ms, Ms^Xm, Ms^Xm, Ms^Xm, Ms^Xm
Ha, Ha, Ms, Ms^Xm, Ha, Ms^Xm, Ha, Ha^Fpa, Ha^Fpa, Ha^Fpa, Ha, Ha^Fpa, Ms, Ms, Ms, Ms, Ms^Xm, Ms^Xm, Ms^Xm, Ms^Xm, Ha, Ha, Ha, Gll^Fmw, Aa, Gll^Fp, Aa, Re, Re, Re, Re, Gs, Gs, Gs, Ha, Ms, Ms, Ms, Ms, Ms, Ms, Ms, Ms^Xm, Ms^Xm, Ms^Xm, Ms^Xm
Ms, Ms, Ha, Ha^Fpa, Ha^Fpa, Ha^Fma, Ha^Fma, Ha^Fpa, Ha, Ha, Ms^Xm, Ms, Ms, Ms, Ms, Ms, Ms^Xm, Ms^Xm, Ms, Ms, Ha, Ha, Aa^Fpa, Aa, Gs, Aa, Re, Re, Re, Re, Gs, Aa, Aa, Aa, Ha, Ms, Ms, Ms, Ms, Ms, Ms, Ms^Xm, Ms^Xm, Ms^Xm, Ms^Xm, Ms^Xm
Ms, Ms, Ha, Ha^Fpa, Ha, Ha^Fpa, Ha^Fpa, Ha, Ha, Ms^Xm, Ms^Xm, Ms, Ms, Ms, Ha^Fpa, Ha^Fpa, Ha^Fpa, Ms, Ms, Ms, Ms, Ha, Gll^Fp, Gll^Fp, Gs, Re, Re, Re, Re, Re, Aa, Aa, Aa, Ha, Ms, Ms, Ms, Ms, Ms, Ms, Ms, Ms^Xm, Ms^Xm, Ms^Xm, Ms^Xm, Ms^Xm
Ms, Ms, Ms, Ha, Ms^Xm, Ha, Ms^Xm, Ha, Ms^Xm, Ms^Xm, Ms^Xm, Ms^Xm, Ha, Ha, Aa, Aa^Fpa, Ha, Ms, Ms, Ms, Ha, Ha, Gll^Fp, Gll^Fp, Aa, Re, Aa, Re, Gs, Gs, Gll^Fp, Gs, Ha, Ms, Ms, Ms, Ms, Ms, Ms, Ms, Ms, Ms, Ms, Ms^Xm, Ha, Ha
Ms, Ms, Ms, Ms, Ms^Xm, Ms^Xm, Ms^Xm, Ms^Xm, Ms^Xm, Ms^Xm, Ms, Ms, Ha, Aa^Fma, Ha^Fma, Ha, Ms, Ms, Ms, Ha, Aa, Gs, Gs, Gs, Re, Aa, Re, Re, Gll^Fmw, Gll^Fp, Ha, Ha^Fma, Ms, Ms, Ms, Ms, Ms, Ms, Ms, Ms, Ms, Ms, Ms, Ha, Ms^Xm, Ms^Xm
Ms^Xm, Ms^Xm, Ms^Xm, Ms^Xm, Ms, Ms^Xm, Ms, Ms^Xm, Ms^Xm, Ms^Xm, Ms, Ms, Ms, Aa, Aa^Fma, Ms, Ha, Ms, Ha, Aa, Gs, Aa, Re, Re, Re, Re, Re, Re, Gll^Fmw, Gll^Fmw, Ha^Fpa, Ms, Ms, Ms, Ms, Ms, Ms, Ms, Ms^Xm, Ms, Ms, Ms, Ms, Ha, Ms^Xm, Ms^Xm
Ms^Xm, Ms^Xm, Ms^Xm, Ms, Ms, Ms, Ms, Ms, Ms, Ms^Xm, Ms, Ms, Ms, Ha, Aa^Fma, Ha, Ha, Aa, Aa, Aa, Gs, Aa, Re, Re, Aa, Re, Aa, Gll^Fmw, Gs, Ha, Ha^Fma, Ha, Ms, Ms, Ms, Ms, Ms^Xm, Ms^Xm, Ms^Xm, Ms^Xm, Ms, Ms, Ms, Ms^Xm, Ms^Xm, Ms^Xm
Ms^Xm, Ms^Xm, Ms, Ms, Ms, Ms, Ms, Ms, Ms, Ms, Ms, Ms, Ha^Fma, Ha, Ha, Ha^Fma, Gll^Fp, Gs^Vea, Re, Re, Re, Re, Re, Re, Aa, Aa, Gs, Gll^Fp, Gll^Fp, Ha^Fma, Ha, Ha, Ms^Xm, Ms, Ms, Ms, Ms^Xm, Ms^Xm, Ms^Xm, Ms^Xm, Ms, Ms, Ms, Ms^Xm, Ms^Xm, Ms^Xm
Ms, Ms, Ms, Ms, Ms, Ms, Ms, Ms, Ms^Xm, Ms, Ms, Ha, Ha, Ha, Gll^Fp, Gll^Fp, Aa, Gll^Fp, Re, Re, Re, Re, Aa, Re, Gs, Gs, Gs, Gs, Ms, Ha, Ha, Ms^Xm, Ms^Xm, Ms^Xm, Ms^Xm, Aa, Ms^Xm, Ms^Xm, Ms^Xm, Ms^Xm, Ms, Ms, Ms, Ms, Ms, Aa
Ms, Ms, Ms, Ms, Ms, Ms, Ms^Xm, Ms^Xm, Ms^Xm, Ms^Xm, Ha^Fpa, Ms, Ha, Gs, Gll^Fmw, Aa, Gs, Re, Re, Re, Re, Aa, Aa, Aa, Gs, Gs, Ha, Ms, Ms, Ms, Ms, Ms^Xm, Ms^Xm, Ms^Xm, Ms^Xm, Ms^Xm, Ms^Xm, Ms^Xm, Ms^Xm, Ms^Xm, Ms, Ms, Ms, Ms, Ms, Aa
Ms, Ms, Ms, Ms, Ms^Xm, Ms^Xm, Ms^Xm, Ms^Xm, Ms^Xm, Ms^Xm, Ha, Ha^Fpa, Ha^Fma, Gll^Fmw, Gll^Fmw, Aa, Aa, Re, Re, Re, Aa, Aa^Fma, Ha^Fma, Ha^Fma, Ha, Ha, Ha, Ms, Ms, Ms, Ms, Ms, Ms^Xm, Ms^Xm, Ms^Xm, Ms^Xm, Ms, Ms, Ms, Ms, Ms, Ms, Ms, Ms, Ms^Xm, Ms^Xm
Ms, Ms, Ms, Ms^Xm, Ms^Xm, Ms^Xm, Ms^Xm, Ms^Xm, Ms, Ha^Fma, Ha^Fpa, Ha^Fma, Gs, Gll^Fmw, Re, Aa, Aa, Aa, Re, Re, Ha, Ha^Fma, Ms, Ms, Ms, Ms, Ms, Ms, Ms, Ms, Ms, Ms^Xm, Ms^Xm, Ms^Xm, Ms, Ms, Ms, Ms, Ms, Ms, Ms, Ms, Ms, Ms, Ms, Ms^Xm
Ms, Ms, Ms^Xm, Ms^Xm, Ms, Ms, Ms, Ms, Ms, Aa, Ms, Ha, Gs, Gs, Re, Re, Re, Re, Gs, Gs, Aa, Ms, Ms, Ms, Ms, Ms, Ms, Ms, Ms, Ms^Xm, Ms^Xm, Ms^Xm, Ms^Xm, Ms^Xm, Ms, Ms, Ms, Ms, Ms, Ms, Ms, Ms, Ms, Ms, Ms, Ms^Xm
Ms^Xm, Ms^Xm, Ms^Xm, Ms^Xm, Ms, Ms, Ms, Ms, Ms, Ha, Ms, Ha, Gs, Gs, Aa, Re, Re, Gs, Gll^Fmw, Aa^Fma, Aa, Ms, Ms, Ms, Ms, Ms, Ms, Ms, Ms^Xm, Ms^Xm, Ms^Xm, Ms^Xm, Ms^Xm, Ms, Ms, Ms, Ms, Ms, Ms, Ms, Ms^Xm, Ms, Ms, Ms, Ms^Xm, Ms^Xm
Ms^Xm, Ms^Xm, Ms^Xm, Ms, Ms, Ms, Ms, Ms, Ms, Ha, Aa, Ha^Fpa, Aa^Fpa, Gs, Aa, Aa, Re, Re, Gll^Fmw, Aa^Fma, Aa^Fpa, Ms, Ms, Ms, Ms, Ms^Xm, Ms^Xm, Ms^Xm, Ms^Xm, Ms^Xm, Ms^Xm, Ms^Xm, Ms, Ms, Ms, Ms, Ms, Ms, Ms, Ms, Ms^Xm, Ms, Ms, Ms, Ms, Ms^Xm
Ms^Xm, Ms^Xm, Ms, Ms, Aa^Fpa, Aa^Fpa, Ms, Ms, Ms^Xm, Aa, Ha, Aa^Fpa, Ha^Fpa, Gll^Fp, Gll^Fp, Aa, Re, Re, Gs, Aa^Fpa, Aa^Fma, Aa, Ha, Ms, Ms, Ms, Ms, Ms^Xm, Ms, Ms^Xm, Ms^Xm, Ms, Ms, Ms, Ms, Ms, Ms^Xm, Ms, Ms^Xm, Ms^Xm, Ms^Xm, Ms, Ms, Ms, Ms, Ms
Ms^Xm, Ms^Xm, Ms, Ms, Ms, Aa^Fpa, Ms, Ms, Ms^Xm, Ms^Xm, Ms^Xm, Ha, Ha, Gll^Fp, Gll^Fp, Re, Re, Re, Re, Gs, Gs, Ha^Vea, Ha^Fpa, Ms, Ms, Ms, Ha, Ms, Ms, Ha, Ha, Ms, Ms, Ms, Ha, Ms^Xm, Ms^Xm, Ms^Xm, Ms^Xm, Ms^Xm, Ms^Xm, Ms^Xm, Ms^Xm, Ms, Ms, Ms
Ms^Xm, Ms^Xm, Ms^Xm, Ms, Ms, Ms, Ms, Ms, Ms^Xm, Ms^Xm, Ms^Xm, Ms^Xm, Aa, Gs, Aa, Re, Re, Re, Re, Re, Re, Gs, Gs, Ha, Ms, Ha, Ha, Ha, Ha, Ha, Ha^Fpa, Ha^Fpa, Aa, Ha^Fpa, Ha^Fpa, Ha, Ms^Xm, Ms^Xm, Ms^Xm, Ms^Xm, Ms^Xm, Ms^Xm, Ms^Xm, Ms, Ms, Ms
Ms, Ms^Xm, Ms^Xm, Ms^Xm, Ms^Xm, Ms, Ms, Ms, Ha, Ms^Xm, Ha, Aa, Aa, Gll^Fp, Gs, Aa, Gs, Re, Re, Re, Re, Re, Re, Gs, Gs, Aa, Gs, Aa, Aa, Aa^Fpa, Aa, Aa, Ha, Aa^Fpa, Ha^Fpa, Ms^Xm, Ms^Xm, Ms^Xm, Ha, Ms^Xm, Ms, Ms^Xm, Ms^Xm, Ms^Xm, Ms, Ms
Ms, Ms, Ms^Xm, Ms^Xm, Ms^Xm, Ms^Xm, Ms^Xm, Ha, Ha^Fma, Ha^Fma, Ha^Fma, Ha^Fma, Ha, Aa, Aa, Aa, Gs, Gs, Aa, Re, Re, Re, Re, Re, Aa, Re, Aa, Gs, Re, Gs, Re, Gs, Re, Aa, Aa, Ha^Fpa, Ha, Ha, Aa, Ms, Aa, Ms, Ha, Ms, Ms, Ms
Ms, Ms, Ms^Xm, Ms^Xm, Ms^Xm, Ms^Xm, Ms^Xm, Ms^Xm, Ms^Xm, Ha^Fma, Ha, Ha, Ms, Ha, Ha, Ha^Fma, Ha^Fma, Aa, Gll^Fp, Re, Re, Re, Re, Re, Re, Aa, Re, Re, Re, Re, Re, Re, Re, Re, Re, Aa, Gs, Gs, Gs, Aa, Gs^Wm, Aa, Ha, Aa, Ms, Ms
Ms, Ms, Ms, Ms^Xm, Ms^Xm, Ms^Xm, Ms, Ms^Xm, Ms^Xm, Ha, Ms, Ms, Ms, Ms, Ms, Ha^Fma, Ha, Ha, Aa, Gs, Aa, Gs, Aa, Re, Aa, Re, Re, Re, Re, Re, Re, Re, Re, Re, Re, Re, Aa, Cea, Aa^Vha, Gs, Re^Gvs, Gs, Cea, Ha, Aa, Ms
Ms, Ms, Ms, Ms, Ms, Ms, Ms, Ms, Ms^Xm, Ms^Xm, Ms^Xm, Ms, Ms, Ms, Ms, Ms, Ms, Ha, Ha, Aa, Aa, Aa, Ha, Aa, Aa, Aa, Aa, Gs, Gs, Re, Gs, Re, Gs, Re, Re, Re, Re, Aa, Re^Gvs, Re^Gvs, Re^Gvs, Re^Gvs, Re^Gvs, Gs, Gs, Ms
Ms^Xm, Ms, Ms, Ms, Ms, Ms, Ms, Ms, Ms^Xm, Ms^Xm, Ms^Xm, Ms^Xm, Ms^Xm, Ms, Ms, Ms, Ms, Ms, Ms, Ha^Fma, Aa^Fma, Ha^Vea, Ms, Ms, Ha, Ha, Ha^Fpa, Gll^Fp, Ha, Ms, Ms, Aa, Aa, Cea, Gll^Fmw, Re, Re, Aa, Aa, Re^Gvs, Re^Gvs, Re^Gvs, Aa^Vha, Aa, Gs, Ms
Ms^Xm, Ms^Xm, Ms^Xm, Ms, Ms, Ms^Xm, Ms^Xm, Ms^Xm, Ms^Xm, Ms^Xm, Ms^Xm, Ms^Xm, Ms^Xm, Ms^Xm, Ms^Xm, Ms, Ms, Ms, Ms, Aa, Aa, Ha, Ms, Ms, Ha, Ms, Ha, Ha^Fpa, Ha, Ms, Ms, Ms, Ms, Aa, Aa, Re, Re, Re, Re, Cea, Gs, Gs, Aa, Aa, Aa, Ms
Ms^Xm, Ms^Xm, Ms^Xm, Ms, Ms, Ms, Ms^Xm, Ms^Xm, Ms^Xm, Ms^Xm, Ms^Xm, Ms^Xm, Ms^Xm, Ms^Xm, Ms^Xm, Ms^Xm, Ms^Xm, Ms, Ha^Fpa, Ms, Ha, Ha, Ms, Ms, Ha^Fpa, Ha, Ms^Xm, Ha, Ms, Ms, Ms, Ms, Ms, Ha, Aa, Aa^Vha, Gs, Re, Re, Re, Gs, Aa^Vha, Re^Gvs, Gs, Gs, Aa
Ms^Xm, Ms^Xm, Ms^Xm, Ms, Ms, Ms, Ms^Xm, Ms^Xm, Ms, Ms, Ms, Ms, Ms, Ms, Ms^Xm, Ms^Xm, Ms^Xm, Ha^Fpa, Ha, Ha, Ha, Ha, Ms, Ha, Ms^Xm, Ha, Ms^Xm, Ms^Xm, Ms^Xm, Ms^Xm, Ms, Ms, Ms, Ms, Ha^Fma, Aa, Gll^Fmw, Gll^Fmw, Re, Re, Re, Re^Gvs, Re^Gvs, Re^Gvs, Re^Gvs, Ha
Ms^Xm, Ms^Xm, Ms^Xm, Ms, Ms, Ms, Ms^Xm, Ms^Xm, Ms, Ms, Ms, Ms, Ms, Ms, Ms, Ms^Xm, Ms^Xm, Ms^Xm, Ms^Xm, Ms^Xm, Ms^Xm, Ms^Xm, Ms^Xm, Ms^Xm, Ms^Xm, Ms^Xm, Ms^Xm, Ms^Xm, Ms^Xm, Ms^Xm, Ms^Xm, Ms, Ms, Ms, Ha^Fma, Aa, Aa, Gll^Fmw, Re, Re, Re, Aa, Gs^Wm, Re^Gvs, Gs, Gs
Ms, Ms^Xm, Ms^Xm, Ms, Ms, Ms, Ms^Xm, Ms^Xm, Ms, Ms, Ms, Ms, Ms, Ms, Ms^Xm, Ms, Ms^Xm, Ms^Xm, Ms, Ms^Xm, Ms, Ms, Ms, Ha^Fpa, Aa^Fpa, Ms^Xm, Ms^Xm, Ms^Xm, Ms^Xm, Ms^Xm, Ms^Xm, Ms^Xm, Ms, Ms, Ha^Fma, Ha^Fma, Aa, Gs, Re, Re, Re, Re, Gs, Gs, Ha, Ms
Ms, Ms, Ms^Xm, Ms^Xm, Ms^Xm, Ms^Xm, Ms^Xm, Ms^Xm, Ms, Ms, Ms, Ms, Ms^Xm, Ms^Xm, Ms^Xm, Ms^Xm, Ha, Ms, Aa, Ms, Ha, Ha, Ha, Ha, Aa^Fpa, Aa^Fpa, Aa, Aa, Ms^Xm, Ms^Xm, Ms, Ms, Ms, Ms, Ms, Ha, Aa, Cea, Re, Re, Re, Re, Cea, Gs, Ms, Ms
Ms^Xm, Ms^Xm, Ms^Xm, Ms, Ms, Ms, Ms^Xm, Ms^Xm, Ms, Ms, Ms, Ms, Ms, Ms, Ms, Ms^Xm, Ms, Ha^Fpa, Ha, Ha, Ha, Ha, Ms, Ha, Ms, Ha, Ms^Xm, Ms^Xm, Ms^Xm, Ms^Xm, Ms, Ms, Ms, Ms, Ha^Fma, Aa, Gll^Fmw, Re, Re, Re, Re, Gs, Gs, Aa, Ha, Ha
Ms^Xm, Ms^Xm, Ms^Xm, Ms, Ms, Ms, Ms^Xm, Ms^Xm, Ms, Ms, Ms, Ms, Ms, Ms, Ms, Ms, Ms, Ms, Ms, Ms, Ms, Ms, Ms, Ha, Ha, Ms, Ms^Xm, Ms^Xm, Ms^Xm, Ms^Xm, Ms^Xm, Ms^Xm, Ms, Ms, Ha^Fma, Aa, Aa, Gs, Re, Re, Re, Gs, Aa, Aa, Ms, Ms^Xm
Ms, Ms^Xm, Ms^Xm, Ms, Ms, Ms, Ms^Xm, Ms^Xm, Ms, Ms, Ms, Ms, Ms, Ms, Ms^Xm, Ms, Ms, Ms, Ms, Ms, Ms, Ms, Ms, Ha^Fpa, Aa^Fpa, Ms^Xm, Ms^Xm, Ms^Xm, Ms^Xm, Ms^Xm, Ms^Xm, Ms^Xm, Ms^Xm, Ms, Ha^Fma, Ha^Fma, Gs, Gs, Re, Re, Re, Gs, Ha^Fpa, Ms, Ms, Ms
Ms, Ms, Ms^Xm, Ms^Xm, Ms^Xm, Ms^Xm, Ms^Xm, Ms^Xm, Ms, Ms, Ms, Ms, Ms^Xm, Ms^Xm, Ms^Xm, Ms^Xm, Ha, Ms, Aa, Ms, Ha, Ha, Ha, Ha, Aa^Fpa, Aa^Fpa, Aa, Aa, Ms, Ms, Ms, Ms, Ms^Xm, Ms^Xm, Ms, Ha, Aa, Re, Re, Re, Re, Aa^Fma, Ha^Fpa, Ms, Ms, Ms
Ms, Ms, Ms, Ms^Xm, Ms^Xm, Ms^Xm, Ms, Ms, Ms, Ms, Ms^Xm, Ms^Xm, Ms, Ms, Ms, Ha^Fpa, Aa^Fpa, Aa, Aa, Ha, Gs, Ha^Fpa, Aa, Ha, Aa^Fma, Aa, Ha^Fpa, Ha^Fpa, Ms, Ms, Ms, Ms, Ms, Ms, Ha, Ha, Aa^Vea, Re, Re, Re, Gs, Aa, Aa, Ha^Fpa, Ms^Xm, Ms^Xm
Ms, Ms, Ms, Ms, Ms, Ms, Ms, Ms, Ms, Ms^Xm, Ms^Xm, Ms, Ms, Ms, Ms, Ha^Fpa, Ha^Fpa, Ha, Gs, Aa^Vea, Re, Aa, Re, Aa, Re, Aa, Aa, Ha^Fpa, Ha, Ha, Aa, Ha, Ha, Ha, Ha, Gs, Re, Re, Re, Re, Ha, Aa, Aa, Ha, Ms^Xm, Ms^Xm
Ai, Ms, Ai, Ms, Ms, Ms, Ms, Ms, Ms, Ms^Xm, Ms, Ms, Ms, Ms, Ms, Ha, Aa^Fpa, Gs, Re, Re, Re, Re, Re, Re, Re, Re, Re, Gs, Aa, Aa, Aa, Aa, Aa, Aa, Gll^Fp, Gs, Re, Re, Re, Gll^Fp, Aa, Aa, Ha, Ms, Ms^Xm, Ms^Xm
Wo, Wo, Wo, Ai, Wo, Ms, Wo, Wo, Wo^Vm, Ai, Ms, Ms, Ms, Ms, Ha^Fpa, Aa^Fpa, Gs, Re, Re, Re, Re, Re, Re, Re, Re, Re, Re, Re, Re, Re, Re, Gs, Gs, Gs, Re, Re, Re, Re, Aa^Fma, Aa^Fpa, Ha^Fpa, Ha^Fpa, Ms, Ms, Ms, Ms^Xm
Ms, Ms, Ai^Vm, Wo, Ai, Wo, Ai, Ai, Wo, Ai, Wo, Ms, Ww^Vm, Ha^Fpa, Gs, Aa, Re, Re, Re, Re, Gs, Re, Gs, Re, Gs, Re, Re, Re, Re, Re, Re, Re, Re, Re, Re, Re, Re, Aa, Ha, Ha, Ha, Ms, Ms, Ms, Ms, Ms^Xm
Ms, Ms, Ms, Ai, Ms, Wo, Ms, Ms, Ms^Xm, Wo, Ms, Wo, Ha^Fpa, Wo, Ww, Ww, Ww, Re, Ww, Re, Wwf, Gs, Ms, Gs, Aa^Fma, Gll^Fp, Aa^Fma, Re, Re, Re, Re, Re, Re, Re, Re, Re, Ha^Fpa, Ha, Ha, Ms, Ms, Ms, Ms^Xm, Ms^Xm, Ms^Xm, Ms^Xm
Ms, Ms, Ms, Ms, Ms, Ms, Ms, Ms^Xm, Ms^Xm, Ms, Ms, Ms, Ha, Gs, Aa^Fma, Re, Re, Ww, Re, Ww, Ww, Ww, Wo, Ha^Fpa, Ai, Aa^Fpa, Ha^Fpa, Gll^Fp, Aa^Fpa, Re, Re, Re, Re, Re, Gs, Aa^Fma, Ha^Fpa, Ms, Ms, Ms, Ms^Xm, Ms^Xm, Ms^Xm, Ms^Xm, Ms^Xm, Ms^Xm
Ms, Ms, Ms, Ms, Ms^Xm, Ms, Ms, Ms, Ms, Ms, Ms, Ms, Ha, Aa^Fma, Re^Fma, Re, Re, Re, Gs, Gs, Aa, Ha, Ha, Wo, Wo, Wo, Ai, Wo, Wo, Ha^Vea, Wo, Ai, Ai, Ai, Ai, Ha, Ms, Ms, Ms, Ms^Xm, Ms^Xm, Ms^Xm, Ms^Xm, Ms^Xm, Ms^Xm, Aa
Ms^Xm, Ms^Xm, Ms^Xm, Ms^Xm, Ms^Xm, Ms^Xm, Ms, Ms, Ms, Ms, Ms, Ms, Aa, Aa^Fma, Re, Re, Re, Re, Gs, Aa, Aa, Ha, Ms, Ms, Ms^Xm, Wo^Vm, Ms^Xm, Ms, Ms, Wo, Ms, Ha, Wo, Aa, Wo, Ms, Ms, Ms, Ms^Xm, Ms^Xm, Ms^Xm, Ms^Xm, Ms^Xm, Ms^Xm, Ms, Aa
Ms, Ms^Xm, Ms^Xm, Ms^Xm, Ms^Xm, Ms^Xm, Ms, Ms, Ms, Ms, Ms, Ms, Aa, Aa^Vea, Re, Re, Re, Gs, Gll^Fp, Aa, Aa, Ha, Ms, Ms^Xm, Ms^Xm, Ms^Xm, Ms^Xm, Ms^Xm, Ms^Xm, Ms^Xm, Ms^Xm, Ms, Ms^Xm, Wo, Ms^Xm, Ai, Wo, Ms^Xm, Ms^Xm, Ms^Xm, Ms^Xm, Ms^Xm, Ms^Xm, Ms, Ms^Xm, Aa
Ms, Ms, Ms^Xm, Ms^Xm, Ms, Ms, Ms, Ms, Ha, Ms, Ha^Fma, Aa, Ha^Fpa, Gs, Re, Re, Re, Gs, Gs, Gll^Fp, Aa, Ha, Ms, Ms^Xm, Ms^Xm, Ms, Ha, Ha, Ms^Xm, Ms^Xm, Ms^Xm, Ms^Xm, Ms^Xm, Ms^Xm, Ms^Xm, Ms^Xm, Wo, Wo^Vm, Wo, Wo, Wo, Ms^Xm, Ms^Xm, Ms^Xm, Wo, Aa
Ms, Ms, Ms^Xm, Ms^Xm, Ms^Xm, Ms, Ms, Ms, Ms^Xm, Ha, Ha^Fma, Ha^Fma, Ha^Fma, Gs, Re, Re, Re, Gs, Gs, Aa, Ha^Fma, Aa, Ms, Ms, Ms, Ha, Ha, Ha, Ms^Xm, Ms^Xm, Ms^Xm, Ms^Xm, Ms^Xm, Ms^Xm, Ms^Xm, Ms, Ms, Wo, Ms, Ms, Ms^Xm, Wo, Wo, Wo, Wo, Wo
Ms, Ms, Ms, Ms^Xm, Ms^Xm, Ms^Xm, Ms^Xm, Ms^Xm, Ms^Xm, Ms^Xm, Aa, Ha, Aa, Aa, Re, Re, Re, Re, Re, Gs, Gs, Ha^Fma, Ha, Ha^Fpa, Ha^Fpa, Ha^Fpa, Ms, Ms^Xm, Ms, Ms^Xm, Ms, Ms^Xm, Ms^Xm, Ms^Xm, Ms^Xm, Ms, Ms, Ms, Ms, Ms, Ms^Xm, Wo, Ms^Xm, Ms^Xm, Ms^Xm, Ms^Xm
Ms, Ms, Ms, Ms, Ms, Ms^Xm, Ms, Ms^Xm, Ms^Xm, Ms^Xm, Ha, Aa, Ha^Fpa, Aa, Gs, Re, Re, Re, Re, Re, Re, Gs, Gs, Gs, Ha^Fpa, Ms, Ha^Fpa, Ha, Ha^Fma, Ha^Fma, Ha^Fma, Ms^Xm, Ms^Xm, Ms^Xm, Ms^Xm, Ms, Ms, Ms, Ms, Ms, Ms^Xm, Ms^Xm, Ms^Xm, Ms^Xm, Ms^Xm, Ms^Xm
Ms, Ms, Ms, Ms, Ms, Ms, Ha, Ms^Xm, Ms^Xm, Ha, Ms^Xm, Ha, Ha, Aa, Gll^Fmw, Gll^Fp, Re, Re, Re, Re, Re, Re, Re, Gs, Gs, Ha^Fpa, Ha^Fpa, Ms, Ms, Ha^Fma, Ha, Ms, Ms, Ms^Xm, Ms^Xm, Ms^Xm, Ms^Xm, Ms^Xm, Ms^Xm, Ms^Xm, Ms^Xm, Ms^Xm, Ms^Xm, Ms^Xm, Ms^Xm, Ms^Xm
Ms, Ms, Ms, Ms, Ms, Ms, Ha, Ha, Ms^Xm, Ms^Xm, Ms^Xm, Ms^Xm, Ms^Xm, Ha, Ha, Gll^Fmw, Gs, Re, Re, Aa, Re, Aa, Aa, Aa, Aa^Vea, Ha^Fpa, Ms, Ms, Ms, Ha, Ms, Ha, Ms, Ms, Ms^Xm, Ms^Xm, Ms^Xm, Ms^Xm, Ms, Ms^Xm, Ms^Xm, Ms^Xm, Ms^Xm, Ms^Xm, Ms^Xm, Ms^Xm
Ms, Ms, Ms, Ms, Ms, Ha, Ms, Ms^Xm, Ms^Xm, Ms^Xm, Ms^Xm, Ms^Xm, Ms^Xm, Ms^Xm, Ha, Ha, Ha, Ha^Fpa, Ha^Fpa, Gs, Re, Re, Aa, Aa, Aa, Ha, Ha, Ms, Ms, Ms, Ms, Ms, Ms, Ms, Ms^Xm, Ms^Xm, Ms^Xm, Ms^Xm, Ms, Ms, Ms, Ms^Xm, Ms^Xm, Ms^Xm, Ms^Xm, Ms^Xm
Ms, Ms, Ms, Ms, Ms, Ms, Ms, Ms^Xm, Ms^Xm, Ms^Xm, Ms^Xm, Ms^Xm, Ms^Xm, Ms^Xm, Ms^Xm, Ms^Xm, Ms^Xm, Ha, Ha, Aa, Gs, Re, Re, Re, Aa, Aa, Ha, Ms, Ms, Ms, Ms^Xm, Ms^Xm, Ms^Xm, Ms^Xm, Ms^Xm, Ms^Xm, Ms^Xm, Ms, Ms, Ms, Ms, Ms, Ms^Xm, Ms^Xm, Ms^Xm, Ms^Xm
Ms, Ms, Ms, Ms, Ms, Ms, Ms, Ms, Ha^Fpa, Ms^Xm, Ms^Xm, Ms^Xm, Aa^Fpa, Ms^Xm, Ms^Xm, Ms^Xm, Ms^Xm, Ms^Xm, Ha, Aa, Re, Re, Re, Re, Gs, Aa, Ha^Fpa, Ms, Ms, Ms, Ms^Xm, Ms^Xm, Ms^Xm, Ms^Xm, Ms^Xm, Ms^Xm, Ms^Xm, Ms^Xm, Ms, Ms, Ms, Ms^Xm, Ms^Xm, Ms^Xm, Ms^Xm, Ms^Xm
Ms, Ms, Ms^Xm, Ms, Ms, Ms, Ms, Ms, Ha, Ha^Fpa, Ha^Fpa, Aa^Fpa, Aa^Fpa, Aa, Ha, Ha, Aa, Aa, Re, Re, Re, Re, Re, Re, Ha^Fpa, Ha^Fpa, Ha^Fpa, Ms, Ha, Ms, Ms, Ms^Xm, Ms^Xm, Ms^Xm, Ms^Xm, Ms^Xm, Ms, Ms, Ms, Ms, Ms, Ms, Ms^Xm, Ms^Xm, Ms^Xm, Ms^Xm
Ms, Ms^Xm, Ms^Xm, Ms^Xm, Ms, Ms, Ms, Ms, Ms, Ms, Ms, Ha, Aa^Fpa, Ha^Fpa, Aa, Aa, Re, Re, Re, Re, Re, Re, Gs, Gs, Ha^Fpa, Ha, Ms^Xm, Ha, Ms, Ha^Fma, Ms, Ms^Xm, Ms^Xm, Ms^Xm, Ms, Ms, Ms, Ms, Ms, Ms, Ms, Ms, Ms^Xm, Ms^Xm, Ms^Xm, Ms^Xm
Ms, Ms, Ms^Xm, Ms^Xm, Ms, Ms, Ms, Ms, Ms, Ms, Ha, Aa^Fpa, Aa^Fpa, Ha^Fpa, Gs, Aa, Re, Re, Re, Aa, Aa, Aa, Ha, Ms, Ms, Ms^Xm, Ms^Xm, Ms^Xm, Ms^Xm, Ms, Ms^Xm, Ms^Xm, Ms^Xm, Ms^Xm, Ms, Ms, Ms, Ms, Ms, Ms, Ms, Ms, Ms^Xm, Ms^Xm, Ms^Xm, Ms^Xm
Ms, Ms, Ms^Xm, Ms^Xm, Ms, Ms, Ms, Ms, Ha^Fma, Ha^Fma, Aa^Fma, Aa, Ha, Ha, Gll^Fmw, Gll^Fmw, Re, Re, Re, Aa, Aa, Ha^Fpa, Ha^Fpa, Ha, Ha^Fma, Ms, Ms, Ms^Xm, Ms^Xm, Ms^Xm, Ms^Xm, Ms^Xm, Ms, Ms, Ha^Fpa, Ms, Ha, Ms, Ha, Ha^Fpa, Ha, Ms, Ms, Ms^Xm, Ms^Xm, Ms^Xm
Ms, Ms, Ms^Xm, Ms^Xm, Ms^Xm, Ms, Ms, Ha^Fma, Ha, Aa, Aa, Aa, Ha, Ha, Gll^Fmw, Gs, Re, Re, Re, Gs, Aa, Ha, Ha^Fpa, Ms, Ha^Fpa, Ha^Fma, Ha^Fpa, Ms, Ms, Ms^Xm, Ms, Ms, Aa^Fpa, Aa^Fpa, Aa, Aa, Aa^Fma, Aa, Aa, Ha^Fpa, Ha, Ms, Ms, Ms, Ms, Ms^Xm
Ms^Xm, Ms^Xm, Ms^Xm, Ms^Xm, Ms^Xm, Ms^Xm, Ms, Ha, Ms, Ms, Ms, Aa, Ha^Fma, Gll^Fp, Gs, Gs, Re, Re, Aa, Gs, Gs, Aa^Fpa, Aa^Fpa, Ha^Fpa, Ha, Ha^Fma, Ha^Fpa, Ha^Fpa, Ha, Ms, Aa^Fma, Aa^Fma, Re, Re, Re, Re, Re, Aa^Fma, Aa, Ha^Fma, Aa^Fma, Aa^Fma, Aa, Ms, Ms, Ms
Ms^Xm, Ms^Xm, Ms^Xm, Ms^Xm, Ms^Xm, Ms^Xm, Ms^Xm, Ha, Ha, Ha, Ms, Ha^Fma, Aa, Ha, Aa^Vea, Gs, Re, Aa, Re, Re, Re, Re, Re, Ha, Re, Aa^Fpa, Aa, Ha^Fpa, Ha^Fpa, Aa^Vea, Aa^Fma, Aa, Re, Re, Re, Re, Re, Re, Re, Aa, Gll^Fp, Aa^Fpa, Aa^Fpa, Ms, Ms^Xm, Ms
Ms^Xm, Ms^Xm, Ms^Xm, Ms^Xm, Ms^Xm, Ms^Xm, Ms^Xm, Ms, Ms, Ms, Ms, Ha^Fma, Ha, Aa, Gll^Fp, Gs, Gs, Re, Re, Re, Re, Re, Re, Re, Re, Re, Re, Aa, Re, Aa^Fpa, Re, Re, Re, Re, Re, Re, Re, Re, Re, Re, Aa, Aa^Fpa, Aa^Fpa, Ms, Ms, Ms
Ms, Ms^Xm, Ms, Ms^Xm, Ms^Xm, Ms^Xm, Ms^Xm, Ms, Ms, Ms, Ms, Ha, Ha, Aa, Ms, Gll^Fp, Gll^Fp, Gll^Fp, Gs, Re, Re, Re, Re, Re, Re, Re, Re, Re, Re, Re, Re, Re, Re, Re, Gll^Fmw, Gll^Fmw, Gll^Fmw, Re, Re, Re, Re, Aa^Fpa, Ha^Fpa, Ha, Ms, Ms^Xm
Ms, Ms, Ms, Ms, Ms^Xm, Ms^Xm, Ms^Xm, Ms^Xm, Ms, Ms, Ms, Ms, Ms, Ms, Ha, Aa, Ha^Fpa, Gs, Ha, Gs, Gll^Fp, Gs, Gll^Fp, Gll^Fp, Gll^Fp, Re, Re, Re, Re, Re, Gs, Re, Gs, Gll^Fmw, Ha, Ha, Ha, Gs, Re, Re, Re, Aa, Ha, Ms, Ms^Xm, Ms^Xm
Ms, Ms, Ms, Ms, Ms^Xm, Ms^Xm, Ms^Xm, Ms^Xm, Ms^Xm, Ms, Ms, Ms, Ms, Ms, Ms, Aa^Fpa, Ha, Ha, Ms, Ha, Aa, Gll^Fp, Aa, Gll^Fp, Aa, Aa, Aa^Fpa, Aa^Fma, Aa^Fpa, Aa, Ha, Ha, Aa, Aa, Aa^Fma, Ms, Ha^Fpa, Ha, Ha^Vea, Re, Re, Re, Ha, Ms, Ms^Xm, Ms^Xm
Ms, Ms, Ms, Ms, Ms^Xm, Ms^Xm, Ms^Xm, Ms^Xm, Ms^Xm, Ms^Xm, Ms^Xm, Ms, Ms^Xm, Ms, Ms^Xm, Ha, Ms, Ms, Ha, Aa, Aa, Aa^Fma, Ha^Fma, Ha^Fma, Ms, Ha, Ha, Ha, Ms, Ms, Ms^Xm, Ms^Xm, Ms^Xm, Ms, Ms^Xm, Ms^Xm, Ms^Xm, Ha^Fpa, Ha^Fma, Re, Re, Re, Aa, Ha, Ms^Xm, Ms^Xm
Ms, Ms, Ms, Ms, Ms, Ms, Ms, Ms, Ms, Ms^Xm, Ms^Xm, Ms^Xm, Ms^Xm, Ms^Xm, Ms^Xm, Ms^Xm, Ms^Xm, Ms, Ms, Ha, Ms, Ha, Ms^Xm, Ms, Ms^Xm, Ms^Xm, Ms^Xm, Ms^Xm, Ms^Xm, Ms^Xm, Ms^Xm, Ms, Ha, Ms^Xm, Ms, Ms^Xm, Aa^Fma, Aa^Fma, Ha^Fma, Re, Re, Re, Aa, Aa, Ms, Ms^Xm
Ms, Ms, Ms, Ms, Ms, Ms, Ms, Ms, Ms, Ms, Ms^Xm, Ms^Xm, Ms^Xm, Ms^Xm, Ms^Xm, Ms^Xm, Ms^Xm, Ms^Xm, Ms^Xm, Ms, Ms, Ms, Ms^Xm, Ms^Xm, Ms^Xm, Ms^Xm, Ms^Xm, Ms^Xm, Ms, Ms, Ha, Ha, Ms, Ha, Ha, Aa^Fma, Aa, Aa, Ha, Ha, Re, Re, Gs, Ha^Fpa, Ha^Fpa, Ms^Xm
Ms^Xm, Ms^Xm, Ms, Ms, Ms, Ms, Ms, Ms, Ms, Ms, Ms^Xm, Ms^Xm, Ms^Xm, Ms^Xm, Ms^Xm, Ms^Xm, Ms^Xm, Ms^Xm, Ms^Xm, Ms^Xm, Ms^Xm, Ms^Xm, Ha, Ms^Xm, Ms, Ms, Ms, Ms, Ms, Ms, Ha^Fpa, Ha^Fpa, Ha, Ha, Gs, Ha, Re, Gs, Re, Re, Re, Re, Ha, Aa, Ha, Ms^Xm
Ms^Xm, Ms^Xm, Ms^Xm, Ms, Ms^Xm, Ms^Xm, Ms^Xm, Ms^Xm, Ms^Xm, Ms^Xm, Ms, Ms^Xm, Ms^Xm, Ms^Xm, Ha^Fma, Ms, Ms, Ms^Xm, Ms, Ms^Xm, Ms, Ms^Xm, Ha^Fma, Ms^Xm, Ms, Ms, Ms, Ms, Ha, Ha, Ha^Fpa, Ha, Aa, Gs, Aa, Aa, Re, Re, Re, Re, Aa, Gs, Ha, Ms^Xm, Ms^Xm, Ms^Xm
Ms^Xm, Ms^Xm, Ms^Xm, Ms^Xm, Ms^Xm, Ms^Xm, Ms, Ms^Xm, Ms, Ms, Ms, Ms, Ha^Fma, Ha^Fma, Aa^Fpa, Ms, Ms, Ms, Ms, Ms, Ms, Ha^Fma, Ms, Ms, Ha, Ha, Ha, Ha, Re, Gs, Re, Re, Re, Aa, Re, Re, Re, Re, Re, Re, Aa, Aa, Ha^Fpa, Ms^Xm, Ms^Xm, Ms^Xm
Ms^Xm, Ms^Xm, Ms^Xm, Ms^Xm, Ms, Ms, Ms, Ha, Ms, Ms, Ms, Ms, Ms, Ha, Ms, Aa, Ms, Ms, Ms, Ms, Ms, Ms, Ha, Ha^Fpa, Aa^Fpa, Aa, Re, Re, Re, Re, Re, Re, Re, Re, Re, Re, Gs, Re, Aa, Gs, Gs, Aa^Fma, Ha^Fpa, Ha, Ms^Xm, Ms^Xm
Ms^Xm, Ms^Xm, Ms^Xm, Ms^Xm, Ms, Ms, Ms, Ms, Ms, Ms, Ms^Xm, Ms, Ms, Ms, Ms, Ha, Ms, Ms, Ha, Ms, Ha, Ms, Ha, Ha^Fpa, Aa^Fpa, Aa, Re, Re, Re, Re, Re, Re, Re, Re, Gs^Fpa, Aa, Aa^Fpa, Aa, Ha^Fpa, Ms, Ha, Ha, Ha, Ms^Xm, Ms^Xm, Ms^Xm
Ms^Xm, Ms^Xm, Ms^Xm, Ms^Xm, Ms^Xm, Ms, Ms, Ms, Ms^Xm, Ms^Xm, Ms^Xm, Ms^Xm, Ms^Xm, Ms, Ms, Ms, Ha, Ha, Aa^Fma, Ha, Aa, Ha^Vea, Re, Re, Re, Re, Aa, Re, Aa, Re, Aa, Gs, Gs, Gs, Ha^Vea, Ha^Fpa, Ha, Ha^Fpa, Ha, Ha, Ms^Xm, Ms^Xm, Ms^Xm, Ms^Xm, Ms^Xm, Ms
Ms, Ms^Xm, Ms^Xm, Ms^Xm, Ms^Xm, Ms^Xm, Ms^Xm, Ms^Xm, Ms^Xm, Ms^Xm, Ms^Xm, Ms^Xm, Ms, Ms, Ms, Ha, Aa^Fma, Ha^Fma, Aa^Fpa, Aa^Fpa, Gs, Aa, Re, Re, Re, Re, Aa, Aa, Aa, Aa, Ha, Ms, Ms, Ms, Ha, Ms, Ms, Ha, Ms, Ms, Ms^Xm, Ms^Xm, Ms^Xm, Ms^Xm, Ms^Xm, Gs
Ms, Ms, Ms^Xm, Ms^Xm, Ms^Xm, Ms^Xm, Ms^Xm, Ms^Xm, Ms, Ha, Ha, Ms, Ha, Ha, Ms, Ms, Aa, Ha^Fpa, Ha, Ha, Aa^Fpa, Gll^Fmw, Gll^Fmw, Gll^Fmw, Re, Gs, Aa, Gs, Ha^Fma, Ha^Fma, Ms, Ms, Ms^Xm, Ms^Xm, Ms^Xm, Ms^Xm, Ms, Ms, Ms, Ms^Xm, Ms^Xm, Ms^Xm, Ms^Xm, Ms^Xm, Ms^Xm, Ms
Ms, Ms, Ms, Ms^Xm, Ms, Ms^Xm, Ms^Xm, Ms^Xm, Ms, Ms, Ms, Ms, Ms, Ms, Ms, Ha, Ha, Ha^Fpa, Ha^Fpa, Aa^Fpa, Aa^Fpa, Aa, Gll^Fp, Gll^Fmw, Re, Aa^Fpa, Aa^Fpa, Ha, Ha, Ms^Xm, Ms^Xm, Ms^Xm, Ms^Xm, Ms^Xm, Ms^Xm, Ms^Xm, Aa^Fma, Ms, Ms, Ms^Xm, Ms^Xm, Ms^Xm, Ms^Xm, Ms^Xm, Ms^Xm, Ms
Ha, Ha, Aa^Fpa, Ms, Ms, Ms, Ms, Ms, Ms, Ms, Ms, Ms, Ms, Ha, Ha, Gs, Aa^Fpa, Aa^Fpa, Aa^Fpa, Ha^Fpa, Aa^Fpa, Aa^Fpa, Gll^Fmw, Gll^Fmw, Gll^Fp, Gll^Fp, Gll^Fp, Gll^Fp, Ha, Ha, Ms^Xm, Ms^Xm, Ms^Xm, Ms^Xm, Ms^Xm, Ms, Aa^Fma, Aa^Fma, Ms^Xm, Ms^Xm, Ms^Xm, Ms^Xm, Ms^Xm, Ms^Xm, Ms^Xm, Ms
Ha, Ms, Aa^Fpa, Ms, Ms, Ms, Ms, Ms, Ms, Ms, Ms, Ms, Ha, Ha, Gs, Aa^Fpa, Aa, Aa^Fpa, Aa^Fpa, Ha, Ha, Gll^Fp, Re, Re, Gll^Fp, Gll^Fp, Ha^Fma, Ha^Fma, Ms, Ms, Ms^Xm, Ms^Xm, Ms^Xm, Ms^Xm, Ms^Xm, Ms^Xm, Ms^Xm, Ms, Ms^Xm, Ms^Xm, Ms, Ms^Xm, Ms^Xm, Ms^Xm, Ms^Xm, Ms^Xm
Ha, Aa^Fpa, Aa^Fpa, Ms, Ha, Ha, Ha, Ha, Aa, Ms, Ha, Ha, Aa^Fma, Aa^Fma, Gll^Fp, Aa^Fpa, Aa, Aa, Aa, Aa^Fpa, Gs, Re, Re, Gll^Fp, Gll^Fmw, Gll^Fp, Ha^Fma, Ha, Aa^Fma, Ms, Ms, Ha, Ha, Ms^Xm, Ms^Xm, Ms^Xm, Ms, Ms^Xm, Ms, Ms, Ms, Ms^Xm, Ms, Ms^Xm, Ms^Xm, Ms^Xm
Ha, Ha, Ha^Fpa, Ha^Fpa, Ha^Fma, Ha^Fma, Ha^Fma, Ha, Ha, Ha, Aa, Gs, Aa^Fma, Gs^Fma, Gll^Fp, Gll^Fp, Aa^Fma, Gs, Aa, Gll^Fmw, Gs, Re, Re, Re, Re, Aa^Fma, Aa^Fma, Ha, Ha^Fma, Aa^Fma, Ha, Ha^Fpa, Ha^Fpa, Ha, Ha^Fpa, Ha, Ha^Fma, Ms, Ha, Ms, Ms, Ms, Ms, Ms^Xm, Ms^Xm, Ms^Xm
Ha, Aa, Ha, Ha^Fma, Ha^Fma, Aa^Fma, Aa^Fma, Aa^Fma, Aa^Fpa, Aa^Fpa, Aa^Fpa, Aa^Fma, Aa^Fma, Aa^Fma, Aa^Fma, Gll^Fp, Gll^Fp, Aa^Vea, Aa, Aa^Fma, Gs, Re, Re, Re, Re, Re, Re, Cv, Cv, Ha, Aa^Fma, Ha, Aa^Fma, Ha^Fpa, Aa^Vea, Aa^Fma, Aa^Fma, Ha, Ha, Ms, Ms, Ms, Ms, Ms^Xm, Ms^Xm, Ms^Xm
Aa, Aa^Fma, Aa^Fma, Ha^Fma, Aa^Fma, Aa^Fma, Aa^Fma, Aa, Aa^Fma, Aa^Fpa, Aa^Fma, Aa^Fma, Aa^Fma, Aa^Fma, Aa^Fma, Gll^Fp, Gs, Gll^Fp, Gll^Fp, Gll^Fp, Gs, Gs, Gs, Re, Re, Re, Re, Re, Re, Re, Re, Aa^Fma, Aa^Fma, Aa^Fma, Ha^Fma, Aa^Fma, Gs, Aa, Aa^Fpa, Aa^Fpa, Aa, Ms, Ms, Ms, Ms, Ms^Xm
Aa, Aa^Fma, Gll^Fmw, Aa^Fma, Aa^Fma, Aa^Fma, Aa^Fma, Aa^Fma, Aa^Vea, Aa^Fma, Gs, Aa^Fma, Gll^Fmw, Aa, Aa^Fma, Gs, Gs, Gs, Gs, Gs, Gs, Gs, Gs, Re, Re, Re, Re, Re, Re, Re, Re, Gll^Fmw, Gll^Fp, Gll^Fp, Aa^Fma, Aa^Fma, Ha, Ha, Ha^Fpa, Aa^Fpa, Ms, Ms, Ms, Ms, Ha, Ms
Gs, Gll^Fmw, Gll^Fmw, Gll^Fmw, Gll^Fmw, Aa^Fma, Gll^Fmw, Aa^Fma, Aa^Fma, Gll^Fp, Gll^Fp, Gll^Fp, Gll^Fmw, Gll^Fp, Aa^Fma, Gs, Gs, Gs, Gs, Gs, Gs, Gs, Gs, Gs, Re, Re, Re, Re, Gs, Gs, Gs, Re, Gs, Gs, Gs, Ha, Aa^Fma, Ha^Fpa, Ha^Fpa, Aa, Aa, Ms, Ha^Fpa, Ha^Fpa, Ha^Fpa, Ha
Gll^Fmw, Gll^Fmw, Gs, Gll^Fmw, Gll^Fp, Gll^Fp, Gll^Fp, Aa^Fma, Gll^Fmw, Aa^Fma, Gll^Fp, Gll^Fmw, Gll^Fmw, Gll^Fmw, Gll^Fp, Gs, Gs, Gs, 3 Gs, Gs, Gs, Gs, Gs, Gs, Re, Re, Re, Re, Gs, Gs, Gs, Gs, Gs, Gs, Gs, Gs, Gll^Fp, Gll^Fp, Gll^Fp, Aa^Vea, Gll^Fp, Gll^Fp, Aa, Aa^Fpa, Ha, Ha
Gll^Fmw, Gll^Fmw, Gll^Fmw, Gll^Fmw, Gll^Fmw, Gll^Fp, Gll^Fp, Gll^Fmw, Aa, Aa, Gll^Fp, Gll^Fp, Gs, Gll^Fp, Gs, Gs, Gs, Gs, Gs, Gs, Gs, Gs, Gs, Gs, Gs, Re, Re, Re, Gll^Fmw, Gs, Gs, Gs, Re, Gs, Gs, Gs, Gs, Gll^Fp, Gll^Fp, Gll^Fp, Gll^Fp, Gll^Fmw, Gll^Fmw, Aa, Gs, Gs
Gg, Gg, Gg, Gg, Gg, Gg, Gg, Gg, Gg, Gg, Gg, Gg, Gg, Gg, Gg, Gg, Gg, Gg, Gg, Gg, Gg, Gg, Gg, Gg, Gg, Gg, Gg, Gg, Gg, Gg, Gg, Gg, Gg, Gg, Gg, Gg, Gg, Gg, Gg, Gg, Gg, Gg, Gg, Gg, Gg, Gg
Gg, Gg, Gg, Gg, Gg, Gg, Gg, Gg, Gg, Gg, Gg, Gg, Gg, Gg, Gg, Gg, Gg, Gg, Gg, Gg, Gg, Gg, Gg, Gg, Gg, Gg, Gg, Gg, Gg, Gg, Gg, Gg, Gg, Gg, Gg, Gg, Gg, Gg, Gg, Gg, Gg, Gg, Gg, Gg, Gg, Gg
Gg, Gg, Gg, Gg, Gg, Gg, Gg, Gg, Gg, Gg, Gg, Gg, Gg, Gg, Gg, Gg, Gg, Gg, Gg, Gg, Gg, Gg, Gg, Gg, Gg, Gg, Gg, Gg, Gg, Gg, Gg, Gg, Gg, Gg, Gg, Gg, Gg, Gg, Gg, Gg, Gg, Gg, Gg, Gg, Gg, Gg
Gg, Gg, Gg, Gg, Gg, Gg, Gg, Gg, Gg, Gg, Gg, Gg, Gg, Gg, Gg, Gg, Gg, Gg, Gg, Gg, Gg, Gg, Gg, Gg, Gg, Gg, Gg, Gg, Gg, Gg, Gg, Gg, Gg, Gg, Gg, Gg, Gg, Gg, Gg, Gg, Gg, Gg, Gg, Gg, Gg, Gg
Gg, Gg, Gg, Gg, Gg, Gg, Gg, Gg, Gg, Gg, Gg, Gg, Gg, Gg, Gg, Gg, Gg, Gg, Gg, Gg, Gg, Gg, Gg, Gg, Gg, Gg, Gg, Gg, Gg, Gg, Gg, Gg, Gg, Gg, Gg, Gg, Gg, Gg, Gg, Gg, Gg, Gg, Gg, Gg, Gg, Gg
Gg, Gg, Gg, Gg, Gg, Gg, Gg, Gg, Gg, Gg, Gg, Gg, Gg, Gg, Gg, Gg, Gg, Gg, Gg, Gg, Gg, Gg, Gg, Gg, Gg, Gg, Gg, Gg, Gg, Gg, Gg, Gg, Gg, Gg, Gg, Gg, Gg, Gg, Gg, Gg, Gg, Gg, Gg, Gg, Gg, Gg
Gg, Gg, Gg, Gg, Gg, Gg, Gg, Gg, Gg, Gg, Gg, Gg, Gg, Gg, Gg, Gg, Gg, Gg, Gg, Gg, Gg, Gg, Gg, Gg, Gg, Gg, Gg, Gg, Gg, Gg, Gg, Gg, Gg, Gg, Gg, Gg, Gg, Gg, Gg, Gg, Gg, Gg, Gg, Gg, Gg, Gg
Gg, Gg, Gg, Gg, Gg, Gg, Gg, Gg, Gg, Gg, Gg, Gg, Gg, Gg, Gg, Gg, Gg, Gg, Gg, Gg, Gg, Gg, Gg, Gg, Gg, Gg, Gg, Gg, Gg, Gg, Gg, Gg, Gg, Gg, Gg, Gg, Gg, Gg, Gg, Gg, Gg, Gg, Gg, Gg, Gg, Gg
Gg, Gg, Gg, Gg, Gg, Gg, Gg, Gg, Gg, Gg, Gg, Gg, Gg, Gg, Gg, Gg, Gg, Gg, Gg, Gg, Gg, Gg, Gg, Gg, Gg, Gg, Gg, Gg, Gg, Gg, Gg, Gg, Gg, Gg, Gg, Gg, Gg, Gg, Gg, Gg, Gg, Gg, Gg, Gg, Gg, Gg
Gg, Gg, Gg, Gg, Gg, Gg, Gg, Gg, Gg, Gg, Gg, Gg, Gg, Gg, Gg, Gg, Gg, Gg, Gg, Gg, Gg, Gg, Gg, Gg, Gg, Gg, Gg, Gg, Gg, Gg, Gg, Gg, Gg, Gg, Gg, Gg, Gg, Gg, Gg, Gg, Gg, Gg, Gg, Gg, Gg, Gg
Gg, Gg, Gg, Gg, Gg, Gg, Gg, Gg, Gg, Gg, Gg, Gg, Gg, Gg, Gg, Gg, Gg, Gg, Gg, Gg, Gg, Gg, Gg, Gg, Gg, Gg, Gg, Gg, Gg, Gg, Gg, Gg, Gg, Gg, Gg, Gg, Gg, Gg, Gg, Gg, Gg, Gg, Gg, Gg, Gg, Gg
Gg, Gg, Gg, Gg, Gg, Gg, Gg, Gg, Gg, Gg, Gg, Gg, Gg, Gg, Gg, Gg, Gg, Gg, Gg, Gg, Gg, Gg, Gg, Gg, Gg, Gg, Gg, Gg, Gg, Gg, Gg, Gg, Gg, Gg, Gg, Gg, Gg, Gg, Gg, Gg, Gg, Gg, Gg, Gg, Gg, Gg
Gg, Gg, Gg, Gg, Gg, Gg, Gg, Gg, Gg, Gg, Gg, Gg, Gg, Gg, Gg, Gg, Gg, Gg, Gg, Gg, Gg, Gg, Gg, Gg, Gg, Gg, Gg, Gg, Gg, Gg, Gg, Gg, Gg, Gg, Gg, Gg, Gg, Gg, Gg, Gg, Gg, Gg, Gg, Gg, Gg, Gg
Gg, Gg, Gg, Gg, Gg, Gg, Gg, Gg, Gg, Gg, Gg, Gg, Gg, Gg, Gg, Gg, Gg, Gg, Gg, Gg, Gg, Gg, Gg, Gg, Gg, Gg, Gg, Gg, Gg, Gg, Gg, Gg, Gg, Gg, Gg, Gg, Gg, Gg, Gg, Gg, Gg, Gg, Gg, Gg, Gg, Gg
Gg, Gg, Gg, Gg, Gg, Gg, Gg, Gg, Gg, Gg, Gg, Gg, Gg, Gg, Gg, Gg, Gg, Gg, Gg, Gg, Gg, Gg, Gg, Gg, Gg, Gg, Gg, Gg, Gg, Gg, Gg, Gg, Gg, Gg, Gg, Gg, Gg, Gg, Gg, Gg, Gg, Gg, Gg, Gg, Gg, Gg
Gg, Gg, Gg, Gg, Gg, Gg, Gg, Gg, Gg, Gg, Gg, Gg, Gg, Gg, Gg, Gg, Gg, Gg, Gg, Gg, Gg, Gg, Gg, Gg, Gg, Gg, Gg, Gg, Gg, Gg, Gg, Gg, Gg, Gg, Gg, Gg, Gg, Gg, Gg, Gg, Gg, Gg, Gg, Gg, Gg, Gg
