border_size=1
usage=map

Ha, Aa^Fpa, Ha^Fpa, Hhd, Ms, Ms, Ms, Ms, Ms, Ha^Fpa, Ha^Fpa, Ha^Fpa, Ha^Fpa, Ha^Fpa, Ha, Ha^Fpa, Ms, Ha, Ms, Ha, Aa^Fpa, Aa^Fpa, Ha, Ha^Fpa, Aa^Fpa, Ha, Ha, Ha, Ha^Fpa, Ha^Fpa, Ms, Ha^Fpa, Ha^Fpa, Ha^Fpa, Ha
Aa^Fpa, Ms, Ha, Ha, Ms, Ms, Ha, Aa^Fpa, Ha^Fpa, Ha, Aa^Fpa, Ha, Ha^Fpa, Ha^Fpa, Ha^Vct, Ms, Ms, Ms, Ms, Ms, Ms, Ms, Ha, Ha^Fpa, Ha, Ha^Fpa, Ha^Fpa, Ha^Fpa, Ha^Fpa, Ms, Ha, Ms, Ms, Ha, Ha
Ha, Ms, Ms, Ms, Ha, Aa^Fpa, Ha^Fpa, Ha^Vct, Ha, Ha^Fpa, Cea, Cea, Cea, Ha^Fpa, Ha^Fpa, Ha, Ms, Ms, Ha, Ms, Ms, Ha, Ha^Fpa, Aa^Fpa, Cud, Ha^Fpa, Cud, Ha^Fpa, Ha^Fpa, Ha^Vhha, Ha^Fpa, Ms, Ms, Ms, Ha
Ha^Fpa, Ha, Ms, Ms, Ha, Ha, Ha^Fpa, Ha, Aa^Fpa, Cea, Cea, 2 Ke, Cea, Cea, Ha, Aa^Fpa, Ms, Ms, Ms, Ms, Ha^Fpa, Ha^Vhha, Ha, Cud, Cud, Cud, Cud, Cud, Ha^Fpa, Ha^Fpa, Ha, Ms, Ms, Ms, Ms
Aa^Fpa, Ms, Ms, Aa^Fpa, Ha, Ha^Fpa, Ha, Ha^Fpa, Cea, Cea, Cea, Cea, Cea, Ha^Fpa, Ha, Ha, Ms, Ms, Ms, Ms, Ha, Ha, Ha, Cud, Cud, 3 Kud, Cud, Cud, Ha^Fpa, Ha^Fpa, Ha^Fpa, Ms, Ms, Ms, Ms
Ha, Ha, Ms, Ha, Ha^Fpa, Ha^Fpa, Ha^Vct, Ha^Fpa, Ha, Ha, Aa^Fpa, Hhd, Hhd, Ha, Aa^Fpa, Ha^Fpa, Ms, Ms, Ha^Fpa, Ha^Fpa, Aa^Fpa, Ha^Fpa, Ha, Cud, Cud, Cud, Cud, Cud, Ha^Fpa, Ha^Fpa, Ms, Ms, Ms, Ms, Ms
Aa^Fpa, Ms, Ms, Ha^Fpa, Ha, Aa^Fpa, Ha^Fpa, Ha, Ha, Aa^Fpa, Hhd, Hhd, Rb, Aa^Fpa, Ha^Vct, Ha^Fpa, Ha^Fpa, Ms, Ha^Fpa, Ha, Ha, Ha, Ha^Vhha, Ha, Ha^Fpa, Ha, Ha^Fpa, Ha^Fpa, Ha^Fpa, Ha^Fpa, Ha, Ha, Ms, Ms, Ms
Aa^Fpa, Ms, Ms, Ms, Ha^Fpa, Ha, Ha^Fpa, Ha^Fpa, Ha, Ha^Fpa, Ha, Hhd, Ha^Fpa, Ha^Fpa, Aa^Fpa, Ha^Fpa, Ha^Fpa, Ms, Ms, Ha, Ha^Fpa, Ha, Aa^Fpa, Aa^Fpa, Hhd, Ha^Fpa, Ha, Ha, Aa^Fpa, Ha^Fpa, Ha^Fpa, Ha^Fpa, Aa^Fpa, Ms, Ms
Ms, Ms, Ha^Fpa, Ha, Aa^Fpa, Ha^Fpa, Ha^Fpa, Ha, Ha^Fpa, Gd, Aa^Fpa, Hhd, Rb, Ha, Ha, Ha, Ha, Ms, Ms, Ha, Ha^Fpa, Aa^Fpa, Aa^Fpa, Ha, Hhd, Ha, Aa^Fpa, Ha^Vhha, Ha, Aa^Fpa, Ha, Ha^Fpa, Ms, Ms, Ms
Ha^Fpa, Ms, Ha^Fpa, Ha, Ha, Ha, Ha^Fpa, Ha, Ha, Ha^Fpa, Gd, Hhd, Gd, Aa^Fpa, Ha, Ha, Aa^Fpa, Ha, Aa^Fpa, Ha, Ha^Fpa, Aa^Fpa, Rb, Hhd, Aa, Aa^Fpa, Aa^Fpa, Ha, Aa^Fpa, Ha^Fpa, Ms, Ms, Ms, Ms, Ms
Ms, Ms, Aa^Fpa, Ha^Fpa, Ha, Ha, Ha, Ha, Ha, Ha, Aa^Fpa, Aa^Fpa, Aa^Fpa, Rb, Gd, Aa^Fpa, Ha, Ha, Ha, Ha, Aa^Fpa, Aa, Gd, Gd, Aa, Ha, Ha, Ha, Rb, Aa^Fpa, Ha, Ms, Ms, Ms, Ms
Ms, Ha, Ha, Aa^Fpa, Aa^Fpa, Aa^Fpa, Ha, Ha, Aa^Fpa, Aa^Fpa, Aa^Fpa, Aa, Aa^Fpa, Rb, Rb, Ha, Aa^Fpa, Aa^Fpa, Aa^Fpa, Ha, Ha, Aa, Gd, Aa, Aa, Ha, Ha^Fpa, Aa^Fpa, Rb, Aa^Fpa, Aa^Fpa, Aa^Fpa, Aa^Fpa, Ms, Ms
Ms, Ha, Aa^Fpa, Ha, Aa^Fpa, Aa^Fpa, Ha^Fpa, Aa^Fpa, Aa, Aa^Fpa, Aa^Fpa, Aa^Fpa, Aa^Vha, Gd, Rb, Aa^Fpa, Rb, Rb, Aa^Fpa, Aa^Fpa, Aa, Rb, Gd, Aa, Aa^Fpa, Aa^Fpa, Rb, Rb, Aa^Fpa, Aa^Fpa, Aa^Fpa, Aa^Fpa, Ms, Ms, Ms
Ms, Ms, Ms, Aa^Fpa, Ha, Aa^Fpa, Aa^Fpa, Aa^Fpa, Aa^Fpa, Aa^Fpa, Aa^Fpa, Aa^Fpa, Rb, Rb, Gd, Aa^Fpa, Aa^Fpa, Aa, Aa, Aa, Aa^Fpa, Aa^Fpa, Gd, Aa, Aa^Vha, Aa^Fpa, Rb, Rb, Rb, Aa^Fpa, Aa^Fpa, Ha, Ms, Ms, Ms
Ms, Ms, Aa^Fpa, Ha, Aa^Fpa, Aa, Gd, Gd, Aa^Fpa, Aa^Fpa, Aa^Fpa, Aa^Fpa, Rb, Aa^Fpa, Aa^Fpa, Gd, Aa^Fpa, Rb, Rb, Rb, Aa^Fpa, Aa, Rb, Aa^Fpa, Rb, Rb, Aa^Fpa, Gd, Aa^Fpa, Ha^Fpa, Ms, Ms, Ms, Ms, Ha^Fpa
Ha^Fpa, Ms, Aa^Fpa, Ha^Fpa, Ha^Fpa, Aa^Fpa, Aa^Fpa, Aa^Fpa, Gd, Aa, Aa^Fpa, Rb, Rb, Rb, Rb, Rb, Rb, Rb, Rb, Rb, Rb, Rb, Rb, Rb, Rb, Rb, Gd, Aa^Fpa, Rb, Aa, Ha^Fpa, Aa^Fpa, Ha, Ms, Ms
Ha^Fpa, Aa^Fpa, Ms, Aa^Fpa, Aa^Fpa, Aa, Aa^Fpa, Aa^Fpa, Aa^Fpa, Rb, Rb, Rb, Aa^Fpa, Rb, Gd, Rb, Aa, Gd, Gd, Rb, Rb, Aa^Fpa, Aa^Fpa, Gd, Aa^Fpa, Aa, Gd, Aa, Aa^Fpa, Aa^Fpa, Ha^Fpa, Ha, Aa^Fpa, Ms, Ms
Ha^Fpa, Aa^Fpa, Ms, Ha^Fpa, Rb, Aa^Fpa, Aa^Fpa, Aa, Aa, Gd, Rb, Rb, Aa^Fpa, Aa^Fpa, Rb, Rb, Rb, Aa^Vha, Rb, Aa, Rb, Gd, Rb, Gd, Aa^Fpa, Aa^Fpa, Gd, Aa^Fpa, Aa, Aa^Fpa, Aa, Ha^Fpa, Ms, Ms, Ms
Ms, Ha^Fpa, Ms, Aa, Rb, Rb, Rb, Aa, Rb, Aa^Fpa, Rb, Gd, Rb, Rb, Rb, Aa, Aa, Aa, Aa, Ai, Gd, Ai, Rb, Rb, Aa, Gd, Rb, Rb, Aa^Vha, Aa^Fpa, Aa^Fpa, Ms, Ms, Aa^Fpa, Aa^Fpa
Ms, Ms, Aa^Fpa, Aa^Fpa, Aa^Fpa, Aa, Rb, Rb, Aa, Rb, Rb, Rb, Rb, Ss, Aa, Ss, Ai, Ss, Ss, Ss, Ai, Ss, Aa, Aa, Rb, Rb, Rb, Aa^Fpa, Rb, Rb, Ha, Aa^Fpa, Aa^Fpa, Ha^Fpa, Ha^Fpa
Ha^Fpa, Ms, Aa, Ha^Fpa, Aa, Aa^Fpa, Aa^Fpa, Rb, Ai, Ai, Ai, Aa, Gd, Ss, Ai, Ai, Ss, Ai, Ss, Ai, Ai, Ai, Ss, Ss, Aa, Rb, Rb, Aa^Fpa, Hhd, Hhd, Gd, Ha, Gd, Ha, Ha^Fpa
Ha, Aa, Gd, Gd^Vct, Rb, Rb, Ce, Ce, Ce, Gd, Ai, Gd, Gd, Ss, Ss, Ss, Ai, Ss, Ss, Wo, Ai, Ss, Ss, Ai, Ss, Gd, Rb, Rb, Gd, Gd, Aa^Fpa, Rb, Aa^Fpa, Aa^Fpa, Ha
Gd, Aa, Gd, Rb, Rb, Ce, Ce, 1 Ke, Ce, Ce, Gd, Ss, Ss, Ss, Ss, Ss, Ss, Ss, Ss, Ss, Wo, Ai, Ai, Ai, Gd, Ai, Rb, Rb, Aa^Fpa, Gd, Aa, Rb, Rb, Rb, Ha^Fpa
Rb, Rb, Rb, Rb, Gd, Rb, Aa, Ce, Rb, Rb, Rb^Vct, Ss, Ss, Ss, Ai, Ss, Wo, Wo, Wo, Ss, Wo, Ss, Ai, Ss, Ai, Ai, Gd, Aa, Rb, Rb, Rb, Aa^Vha, Aa, Aa^Fpa, Ha
Aa, Rb, Rb, Aa, Rb, Rb^Vct, Rb, Aa, Ss, Aa, Aa, Aa, Ai, Ai, Ss, Wo, Wo, Wo, Wo, Wo, Wo, Wo, Ss, Ai, Ai, Ss, Gd, Rb, Hhd, Gd, Rb, Aa, Aa^Fpa, Aa, Aa^Fpa
Ss, Rb, Aa, Aa^Fpa, Aa, Aa, Aa, Rb, Ss, Aa, Ss, Ai, Ss, Ai, Ai, Ss, Wo, Wo, Wo, Ss, Wo, Ai, Ss, Ai, Ss, Rb, Rb, Rb, Rb, Aa^Fpa, Rb, Rb, Aa, Ms, Ms
Aa, Aa, Aa, Aa, Ss, Aa, Ss, Ss, Rb, Ss, Ss, Ss, Aa, Aa^Fpa, Ai, Ai, Ss, Ss, Ss, Ai, Aa, Aa, Aa, Ai, Rb, Aa, Aa, Rb, Aa, Rb, Rb, Aa^Fpa, Aa, Ms, Ms
Ai, Ss, Ss, Ss, Ss, Ss, Ss, Ss, Ss, Rb, Ss, Rb, Aa^Fpa, Aa^Fpa, Aa^Fpa, Ai, Ai, Ss, Ai, Ai, Aa^Fpa, Aa^Fpa, Rb, Aa, Rb, Aa, Rb, Rb, Aa^Fpa, Aa, Gd, Hhd, Aa^Fpa, Aa^Fpa, Ms
Ss, Ss, Ss, Ss, Ss, Aa^Fpa, Aa^Fpa, Aa^Fpa, Ss, Gd, Rb, Ss, Aa, Aa^Fpa, Aa^Fpa, Aa^Fpa, Aa^Fpa, Ai, Aa^Fpa, Aa^Fpa, Aa^Fpa, Aa, Rb, Rb, Aa, Aa, Rb, Aa^Fpa, Aa^Vha, Aa^Fpa, Aa^Fpa, Aa^Fpa, Ms, Aa^Fpa, Ms
Ai, Ai, Ai, Ai, Ai, Ai, Ss, Ss, Aa, Aa^Fpa, Rb, Aa, Aa, Aa^Fpa, Aa^Fpa, Aa^Fpa, Aa^Fpa, Aa^Fpa, Aa, Aa^Fpa, Rb, Rb, Gd, Rb, Rb, Aa, Rb, Aa, Aa, Aa, Aa^Fpa, Aa^Fpa, Ms, Aa^Fpa, Aa^Fpa
Aa, Aa, Aa^Fpa, Ai, Ai, Aa^Fpa, Aa^Fpa, Aa, Aa, Aa^Fpa, Aa^Fpa, Rb, Rb, Aa, Aa^Fpa, Aa^Fpa, Aa^Fpa, Aa^Fpa, Gd, Rb, Gd, Aa, Aa^Fpa, Rb, Hhd, Rb, Rb, Aa, Rb, Gd, Rb, Ms, Aa^Fpa, Ms, Aa^Fpa
Aa, Rb, Rb, Aa^Fpa, Aa, Aa, Aa^Fpa, Aa, Gd, Rb, Rb, Aa^Fpa, Rb, Rb, Aa, Aa^Fpa, Aa^Fpa, Aa, Hhd, Aa^Fpa, Aa^Fpa, Rb, Rb, Rb, Aa^Fpa, Aa, Aa, Aa, Rb, Ha^Fpa, Ms, Ms, Ms, Ms, Ms
Aa, Aa^Fpa, Hhd, Aa, Gd, Aa^Fpa, Aa, Aa, Rb, Aa, Aa^Fpa, Aa, Hhd, Gd, Gd, Aa, Aa^Fpa, Rb, Gd, Aa^Fpa, Aa^Fpa, Aa, Rb, Aa, Aa, Hhd, Aa^Fpa, Ha^Fpa, Aa^Fpa, Rb, Ha^Fpa, Aa^Fpa, Ms, Ms, Ms
Ha^Fpa, Aa, Aa, Aa^Fpa, Aa^Fpa, Aa, Rb, Gd, Gd, Hhd, Rb, Hhd, Aa, Aa, Aa^Fpa, Rb, Gd, Hhd, Rb, Aa, Aa, Aa^Vha, Aa^Fpa, Rb, Gd, Aa^Fpa, Ha^Fpa, Rb, Rb, Aa^Fpa, Ms, Ms, Ms, Ms, Ms
Aa, Aa, Ha^Fpa, Rb, Aa^Fpa, Aa^Fpa, Aa, Aa, Aa, Hhd, Aa, Aa, Rb, Rb, Rb, Aa, Aa^Fpa, Rb, Aa^Fpa, Aa^Fpa, Rb, Aa, Aa^Fpa, Rb, Rb, Aa^Fpa, Aa, Aa, Aa^Fpa, Aa^Fpa, Aa^Fpa, Ms, Ms, Ms, Ms
Ha, Ha, Rb, Aa, Aa^Fpa, Aa^Fpa, Gd, Aa, Aa, Aa^Fpa, Aa, Aa, Rb, Gd, Aa, Aa, Aa^Fpa, Gd, Aa^Fpa, Aa^Fpa, Rb, Aa^Fpa, Aa, Rb, Aa^Fpa, Gd, Ha^Fpa, Ha^Fpa, Rb, Aa^Fpa, Ha^Fpa, Aa^Fpa, Ms, Ms, Aa^Fpa
Ha, Ha, Aa^Fpa, Ha, Aa, Aa, Aa^Fpa, Aa, Aa^Fpa, Aa^Fpa, Aa^Fpa, Aa, Aa, Rb, Aa^Fpa, Aa^Vha, Aa^Fpa, Gd, Aa^Fpa, Gd, Aa^Fpa, Rb, Aa^Fpa, Aa^Fpa, Aa^Fpa, Aa^Fpa, Aa^Fpa, Gd, Aa^Fpa, Ha^Fpa, Ha^Fpa, Ms, Ms, Ms, Ms
Ms, Ms, Ha, Ha^Fpa, Ha, Aa^Fpa, Ha, Aa, Aa^Fpa, Aa^Fpa, Aa^Fpa, Aa^Fpa, Rb, Rb, Aa, Aa^Fpa, Aa^Fpa, Gd, Rb, Rb, Rb, Gd, Aa^Fpa, Aa^Fpa, Aa^Vea, Aa^Fpa, Rb, Ha^Fpa, Aa^Fpa, Aa^Fpa, Ha^Fpa, Ms, Ms, Aa^Fpa, Rb
Ms, Ha, Rb, Ha, Aa^Fpa, Aa^Fpa, Ha, Aa, Aa^Fpa, Aa, Aa^Fpa, Aa^Fpa, Aa^Fpa, Aa^Fpa, Hhd, Aa^Fpa, Gd, Hhd, Aa^Fpa, Aa^Fpa, Aa, Gd, Aa^Fpa, Aa^Fpa, Aa^Fpa, Aa^Fpa, Ha, Rb, Aa^Fpa, Aa^Fpa, Ha, Ha, Ms, Ms, Ha
Ms, Ms, Aa^Fpa, Ha, Aa^Fpa, Ha, Ha^Fpa, Gd, Hhd, Ha^Fpa, Aa^Fpa, Aa^Fpa, Rb, Hhd, Rb, Gd, Aa^Fpa, Gd, Ha^Fpa, Ha, Gd, Gd, Ha, Ha^Fpa, Ha, Ha, Gd, Ha, Aa^Fpa, Ha^Fpa, Ai, Ai, Ha^Fpa, Ms, Ms
Ms, Ms, Ha^Fpa, Aa^Fpa, Aa^Fpa, Aa^Fpa, Ha^Fpa, Ha^Fpa, Hhd, Ha^Fpa, Aa^Fpa, Aa^Fpa, Aa^Fpa, Ha^Fpa, Rb, Gd, Rb, Aa^Fpa, Ha^Fpa, Ha^Fpa, Aa^Fpa, Ha, Aa^Fpa, Ha, Ha, Aa^Fpa, Aa^Fpa, Aa^Fpa, Ha^Fpa, Rb, Ha, Ha, Aa^Fpa, Ha^Fpa, Ha
Ms, Ms, Ha, Ha^Fpa, Ha, Aa^Fpa, Ha, Ha^Fpa, Ha^Fpa, Ha^Fpa, Aa^Fpa, Aa^Fpa, Rb, Gd, Rb, Gd, Aa^Fpa, Aa^Fpa, Ha^Fpa, Ha, Aa^Fpa, Ha, Aa^Fpa, Ha^Fpa, Ha, Ha^Vea, Ha^Fpa, Aa^Fpa, Aa^Fpa, Ha^Fpa, Aa^Fpa, Ms, Ms, Ms, Ha^Fpa
Ms, Ha^Fpa, Ms, Ha^Fpa, Aa^Fpa, Ha, Ha^Fpa, Ha, Aa^Fpa, Aa^Fpa, Ha, Hhd, Rb, Aa^Fpa, Aa^Fpa, Aa^Fpa, Rb, Gd, Ha, Aa^Vea, Ha, Ha, Cv, Ha, Cv, Aa^Fpa, Aa^Fpa, Rb, Ha, Aa^Fpa, Aa^Fpa, Aa^Fpa, Ha^Fpa, Ms, Ha
Ha^Fpa, Ms, Ms, Aa^Fpa, Ha^Fpa, Ha, Aa^Fpa, Ha, Ha, Ha, Ha^Fpa, Aa^Fpa, Aa^Fpa, Ha, Aa^Fpa, Rb, Aa^Fpa, Rb, Rb, Aa^Fpa, Ha, Cv, Cv, Cv, Cv, Cv, Ha, Ha, Ha^Vea, Ha, Rb, Aa^Fpa, Ha^Fpa, Ms, Ms
Ms, Ms, Aa^Fpa, Ha^Fpa, Ha, Ha, Ha^Fpa, Ha^Fpa, Ha^Fpa, Aa^Fpa, Aa^Fpa, Ha, Ha, Ha^Fpa, Ha, Rb, Aa^Fpa, Aa^Fpa, Gd, Aa^Fpa, Ha, Cv, Cv, 4 Kv, Cv, Cv, Ha, Ha^Fpa, Aa^Fpa, Ha^Fpa, Ha^Fpa, Ms, Ms, Ms, Ms
Ms, Ms, Ms, Ha^Fpa, Aa^Fpa, Ha^Fpa, Ha, Ha^Fpa, Aa^Fpa, Ha, Ha^Fpa, Aa^Fpa, Rb, Aa^Fpa, Ha^Fpa, Aa^Fpa, Ha, Aa^Fpa, Rb, Aa^Fpa, Aa^Fpa, Cv, Cv, Cv, Cv, Cv, Aa^Fpa, Ha^Fpa, Aa^Fpa, Ha^Fpa, Ms, Ms, Ha^Fpa, Ms, Ms
Ha, Ms, Ha^Fpa, Ha^Fpa, Aa^Fpa, Ha, Ha, Ha^Fpa, Ha, Ha, Ha, Ha, Ha, Gd, Ha^Fpa, Aa^Fpa, Ha, Ha, Ha, Ha^Fpa, Rb, Ha, Aa^Fpa, Ha, Ha^Fpa, Ha, Aa^Fpa, Ha^Fpa, Ha^Fpa, Ms, Ha, Ms, Ms, Ms, Ms
Ms, Ha, Ms, Ha^Fpa, Ms, Ha^Fpa, Ha^Fpa, Ha, Ha^Fpa, Aa^Fpa, Ha^Fpa, Aa^Fpa, Ha^Fpa, Ha^Fpa, Ha^Fpa, Aa^Fpa, Aa^Fpa, Ha^Fpa, Aa^Fpa, Rb, Aa^Fpa, Ha, Aa^Fpa, Ha^Fpa, Ha^Fpa, Ha^Vea, Aa^Fpa, Ms, Ms, Ms, Ms, Ms, Ms, Ms, Ms
Ms, Ms, Ha, Ms, Ha^Fpa, Ms, Ms, Ms, Ha^Fpa, Ha, Aa^Fpa, Ha^Fpa, Ha, Ha^Fpa, Ms, Ms, Aa^Fpa, Ha^Fpa, Ha^Fpa, Ha^Fpa, Ha^Fpa, Ha^Vea, Ha^Fpa, Aa^Fpa, Ms, Ms, Ms, Ha^Fpa, Ms, Aa^Fpa, Aa^Fpa, Ms, Ha, Ms, Ms
Ms, Ms, Ms, Ms, Ms, Ms, Ms, Ha, Ha, Ha, Ms, Ms, Ms, Ms, Ms, Ha, Ha^Fpa, Aa^Fpa, Ha, Aa^Fpa, Ha^Fpa, Ha^Fpa, Ms, Ms, Ms, Ms, Ms, Ms, Ms, Ms, Ms, Ms, Ms, Ms, Ha
Ha^Fpa, Ms, Ha^Fpa, Ms, Ms, Ms, Ms, Ha, Ha, Ha, Ms, Ha, Ha^Fpa, Ms, Gll^Fp, Ms, Aa^Fpa, Ha, Rb, Aa^Fpa, Gd, Ms, Ha, Aa^Fpa, Aa^Fpa, Ms, Gll^Fp, Ms, Ha^Fpa, Ms, Aa^Fpa, Aa^Fpa, Aa^Fpa, Ms, Gd
