Aa, Ha, Ha, Ha, Aa, Ha, Aa, Ha, Aa, Aa, Aa, Aa, Rb, Ww, Ww, Ww, Wo, Ha, Ha^Fma, Aa, Aa, Aa, Aa, Aa, Ha, Aa, Aa^Fma, Aa, Aa^Fma, Aa, Kv, Aa^Fma, Aa^Fma, Aa^Fma, Aa^Fma, Aa, Aa^Fma, Aa^Fma, Aa^Fma, Aa^Fma, Aa^Fma, Aa^Fma, Aa^Fma, Aa^Fma, Ha^Fda, Ha, Ha^Fma, Aa^Fma, Aa^Fpa, Aa^Fda, Aa^Fda, Aa^Fda, Ha^Fda, Aa, Aa^Fma
Ha, Ha, Aa, Ha, Aa, Aa, Aa, Aa, Ha, Aa, Ha, Aa, Re, Ww, Aa, Ww, Wo, Wo, Wo, Wo, Wo, Ha, Aa, Aa, Aa, Aa, Aa, Aa^Fma, Aa^Fma, Aa^Fda, Aa^Fda, Aa^Fda, Aa^Fda, Aa^Fda, Gll^Fda, Aa^Fma, Ha^Fpa, Aa^Fda, Aa, Aa^Fma, Ha^Fda, Ha^Fma, Aa^Fma, Aa^Fma, Aa^Fda, Gll^Fp, Gll^Fda, Aa^Fda, Aa^Fpa, Aa^Fma, Ha^Fda, Ha^Fpa, Aa^Fpa, Aa^Fma, Aa^Fda
Ha, Aa, Ha, Rb, Re, Rb, Ha, Ha^Vct, Ch, Ch, Ch, Ha^Vct, Ha, Ha^Fma, Ha, Ww, Ww, Wo, Ww, Wo, Ww, Wo, Ha^Fpa, Aa, Aa, Aa, Aa, Aa^Fma, Aa^Fma, Aa^Fma, Aa^Fma, Aa, Aa^Fda, Aa^Fpa, Aa^Fpa, Aa^Fpa, Aa^Fpa, Aa, Aa^Fma, Aa^Vea, Aa^Fda, Ha^Fma, Cv, Aa, Aa^Fpa, Aa^Fda, Aa^Fma, Aa^Fda, Gll^Fda, Gll^Fp, Aa^Fpa, Aa^Fda, Gll^Fda, Gll^Fda, Aa^Fda
Ha, Ha, Ha, Ha, Aa, Aa, Ha, Ha^Fma, Ch, Kha, Cha, Cha, Cha, Ha, Aa, Ww, Ha, Ww, Ha, Ww, Ww, Ww, Ww, Ha, Aa, Ha^Fpa, Aa, Aa, Aa, Ha^Fma, Ha^Fma, Ha^Fda, Aa^Fma, Aa, Aa^Fpa, Aa^Fpa, Cv, Aa^Fpa, Aa^Vea, Aa^Fda, Cv, Cv, Aa^Fma, Cv, Cv, Aa^Vea, Ha^Fpa, Aa, Aa, Aa^Fma, Ha^Fpa, Ha^Fda, Gll^Fp, Aa^Fpa, Aa^Fpa
Ha, Ha, Ha^Fma, Ha, Ha, Aa, Ha, Ha, Cha, Cha, Cha, Kha, Cha, Rb, Rb, Rb, Rb, Rb, Re, Ha, Ha, Ha, Aa, Ww, Ww, Ha, Aa^Fpa, Aa, Aa, Aa^Fma, Aa^Fma, Kv, Aa^Fma, Aa^Fda, Aa^Fda, Cv, Cv, Aa^Fpa, Aa^Fpa, Aa^Fma, Gll^Fma, Cv, 3 Kv, Ha^Fpa, Cv, Ha^Fpa, Aa^Fda, Aa, Aa^Fma, Ha^Fma, Aa, Aa, Aa^Fda, Gll^Fda, Gll^Fp
Ha, Ha, Ha, Ha, Aa, Aa, Ha, Ha^Vct, Cha, 2 Kha, Cha, Cha, Rb, Re^Vct, Re, Rb, Re, Rb, Rb, Re, Re, Aa, Aa, Aa^Fpa, Aa, Ww, Aa, Aa^Fpa, Aa, Ha^Fma, Ha^Fma, Aa^Fma, Aa^Fda, Aa, Aa, Ha^Fda, Aa^Fma, Ha^Fpa, Aa^Fma, Gll^Fp, Gll^Fma, Cv, Cv, Cv, Cv, Gll^Fpa, Aa^Vea, Gll^Fda, Ha^Fpa, Aa^Fma, Aa, Aa^Fma, Aa^Fpa, Gll^Fp, Aa^Fma
Ha, Ha^Fma, Ha, Ha, Aa, Ha, Ha, Ha^Fma, Ha, Cha, Ha^Vct, Ha, Aa, Re, Ha, Rb, Rb, Rb, Re, Rb, Re, Ha, Rb, Aa, Ha, Ww, Ww, Ha, Aa, Ha, Aa^Fma, Aa^Fma, Aa^Fma, Aa^Fda, Aa^Fma, Aa, Aa^Fpa, Aa^Fpa, Ha^Fpa, Ha^Vea, Gll^Fpa, Ha^Fma, Ha^Fma, Aa^Fma, Gll^Fma, Gll^Fp, Aa^Fda, Aa^Fpa, Aa^Fda, Aa^Fma, Aa^Fpa, Gll^Fda, Aa^Fma, Aa^Fpa, Aa^Fpa
Ha, Ha, Ha, Ha, Aa, Aa, Aa, Ha, Ha, Ha, Ha, Ha, Aa, Ha, Ha^Fma, Ha, Aa, Aa, Aa^Fpa, Rb, Aa, Re, Re, Rb, Rb, Ww, Ww, Ww, Aa, Aa, Aa, Aa^Fma, Ha^Fma, Ha^Fma, Aa^Fma, Kv, Gll^Fpa, Aa^Fda, Aa^Fma, Gll^Fpa, Gll^Fda, Gll^Fda, Aa^Fda, Ha^Fpa, Gll^Fma, Aa^Fpa, Aa^Fda, Cv, Cv, Aa^Fma, Aa^Fda, Aa^Fpa, Ha^Fda, Aa, Aa^Fma
Ha, Ha^Fma, Aa, Aa, Aa, Aa, Ha, Aa, Aa, Aa, Aa, Aa, Ha, Ha, Ha, Aa, Ha, Ha, Aa, Ha, Aa, Rb, Re, Re, Rb, Rb, Rb, Ww, Ww, Aa, Aa, Aa, Aa, Aa^Fma, Gll^Fma, Aa^Fpa, Gll^Fp, Aa, Aa^Fpa, Aa^Fpa, Gll^Fda, Aa^Fda, Gll^Fma, Gll^Fp, Aa^Fma, Aa, Aa^Fma, Cv, Aa^Fpa, Aa^Fpa, Ha^Fda, Aa^Fda, Aa, Aa, Aa
Ha, Ha, Aa, Aa, Ha, Ha^Fma, Ha, Ha, Ha, Ha, Ha, Ha, Aa, Ha, Aa, Ha, Aa, Ha, Aa, Ha, Aa, Aa, Ha, Rb, Re, Re, Rb, Aa, Ww, Aa, Aa, Aa^Fpa, Aa, Aa^Fma, Ha^Fma, Aa^Fma, Aa^Fma, Gll^Fpa, Ha^Fma, Kv, Aa^Fma, Ha^Fda, Gll^Fpa, Ha^Fma, Aa^Fda, Aa^Fma, Aa, Ha^Fpa, Aa^Fpa, Aa^Fpa, Aa^Fda, Aa^Fma, Gll^Fda, Aa, Aa^Fma
Aa, Aa, Ha, Ha, Ha^Fma, Ha, Ha, Ha^Fma, Ha, Aa, Ha, Ha^Fpa, Ha, Ha, Aa, Ha, Ha, Aa, Ha^Fpa, Aa, Ha, Aa^Fpa, Ha, Aa^Fpa, Re, Rb, Rb, Ha^Fpa, Aa, Ww, Ww, Aa^Fpa, Ha, Aa, Aa^Fma, Aa^Fma, Aa^Fpa, Gll^Fpa, Gll^Fp, Aa^Fda, Gll^Fpa, Gll^Fp, Aa^Fma, Aa^Fma, Kv, Aa^Fpa, Aa, Aa^Fpa, Aa^Fma, Kv, Aa^Fpa, Aa^Fma, Ha^Fda, Aa^Fma, Aa^Fma
Aa, Aa, Ha, Ha, Ha, Ha, Ms, Ha, Ha, Ha, Ha, Ha, Aa, Aa, Aa, Aa, Ha, Aa^Fpa, Ha, Aa, Ha, Aa, Ha, Aa, Re, Rb, Rb, Ha, Ha, Ww, Ww, Aa^Fpa, Aa, Aa, Aa, Aa, Aa, Aa^Fma, Gll^Fma, Gll^Fma, Gll^Fda, Gll^Fp, Gll^Fda, Aa^Fda, Aa^Fda, Aa^Fpa, Ha^Fpa, Aa^Fma, Ha^Fda, Ss, Aa^Fda, Aa^Fda, Aa^Fma, Aa, Ha^Fma
Ha, Ha, Ha, Ha, Ha, Ms, Ha, Ha, Wog, Aa, Wog, Aa, Ha, Aa, Wog, Ha, Ha, Aa^Fpa, Aa, Aa, Aa, Aa, Aa, Ha, Aa, Rb, Rb, Ha, Aa, Aa, Ww, Ww, Aa^Fpa, Aa, Aa, Aa^Fma, Ha^Fma, Ha^Fpa, Gll^Fma, Ha^Fpa, Aa^Fpa, Aa^Fpa, Ha^Fda, Aa^Fma, Aa^Fpa, Aa^Fpa, Ha^Fpa, Ha^Fpa, Aa^Vea, Ss, Aa^Fma, Aa^Fma, Ha^Fda, Aa, Aa^Fma
Ms, Ha, Ms, Ms, Ms^Xm, Ms, Ms, Wog, Ms, Ms, Ms, Wog, Ms, Wog, Ms, Wog, Ms, Aa, Aa, Ha, Aa^Fpa, Aa, Aa^Fpa, Aa, Aa, Re, Re, Ha, Aa, Aa, Ww, Ww, Aa, Rb, Ha, Aa^Fpa, Gll^Fp, Aa^Fma, Ha^Fma, Aa^Fma, Aa, Aa^Vea, Aa^Fpa, Aa^Fma, Aa^Fma, Gll^Fda, Ss, Aa^Fma, Ss, Ss, Aa^Fma, Aa^Fda, Aa^Fma, Aa^Fma, Aa^Fma
Ms, Ms, Ha, Ms^Xm, Ms^Xm, Ms^Xm, Ms^Xm, Ms^Xm, Ms^Xm, Ms^Xm, Ms^Xm, Ms, Ms^Xm, Ms, Ms^Xm, Ms, Ms, Ms, Wwg, Aa, Aa, Aa^Fpa, Aa, Aa, Aa, Re, Aa, Rb, Rb, Rb, Ww, Ww, Rb, Rb, Ha, Aa, Aa^Fma, Aa^Fma, Aa^Fpa, Aa, Aa^Fma, Ha^Fma, Ha^Fda, Gll^Fda, Aa^Fda, Ha^Fda, Ss, Ss, Aa^Fpa, Aa^Fma, Ss, Gll^Fda, Gll^Fda, Aa^Fma, Ss
Ms, Ms, Ms^Xm, Ms, Ms^Xm, Ms^Xm, Ms^Xm, Ms^Xm, Ms^Xm, Ms^Xm, Ms^Xm, Ms^Xm, Ms^Xm, Ms^Xm, Ms^Xm, Ms^Xm, Ms^Xm, Ms, Ms, Ms, Aa, Aa^Vha, Aa, Rb, Rb, Rb, Rb, Rb, Re, Aa, Ww, Ha, Aa, Aa, Aa^Fpa, Aa^Fpa, Ha^Fma, Aa^Fma, Gll^Fda, Aa^Fma, Ha^Fda, Ss, Aa^Fma, Ss, Gll^Fda, Aa^Fpa, Aa^Fma, Ss, Ss, Ss, Aa^Fpa, Gll^Fda, Aa^Fma, Ss, Ss
Ms, Ms^Xm, Ms^Xm, Ms^Xm, Ms^Xm, Ms^Xm, Ms^Xm, Ms^Xm, Ms, Ms^Xm, Ms^Xm, Ms^Xm, Ms^Xm, Ms^Xm, Ms^Xm, Ms^Xm, Ms^Xm, Ms^Xm, Ms^Xm, Ms^Xm, Aa, Aa, Aa, Aa, Aa, Ha, Rb, Ha, Rb, Rb, Ww^Bw\, Rb, Aa, Rb, Rb, Aa, Aa, Ha^Fma, Gll^Fda, Gll^Fda, Aa^Fpa, Ss, Ss, Gll^Fda, Aa^Fpa, Ha^Fda, Ss, Wwg, Wwg, Ss, Ss, Aa^Fpa, Aa^Fma, Aa, Aa^Fma
Ms^Xm, Ms^Xm, Ms^Xm, Ms^Xm, Ms^Xm, Ms^Xm, Ms, Ms^Xm, Ms, Ms^Xm, Ms, Ms^Xm, Ms, Ms^Xm, Ms, Ms^Xm, Ms^Xm, Ms^Xm, Ms, Wwg, Aa^Fpa, Aa, Aa, Ha, Rb, Ha, Ha, Re, Re, Aa, Ww, Rb, Rb, Rb, Aa^Fpa, Rb, Ha, Ha^Fma, Aa^Fma, Aa^Vea, Aa^Fpa, Aa^Fma, Aa^Fda, Ss, Aa^Fma, Aa^Fpa, Ha^Fma, Aa^Fma, Wwg, Ss, Ss, Aa^Fpa, Ss, Ss, Aa^Fma
Ms^Xm, Ms^Xm, Ms, Ms, Ms, Ms, Ms, Ms, Ha^Vhha, Ha, Aa, Ms, Wwg, Ms, Aa, Ms, Ms, Ms, Aa, Ai, Wwg, Aa^Fpa, Aa^Fpa, Aa^Fpa, Re, Aa, Ha, Rb, Rb, Rb, Ww^Bw\, Ww, Rb, Aa, Ha, Re, Rb, Aa^Fma, Aa^Fma, Aa^Fma, Ss, Aa^Fma, Ss, Ss, Aa^Fma, Ss, Ss, Wwg, Ss, Ss, Ss, Ss, Aa^Fma, Aa^Fpa, Aa^Fma
Ms, Ms, Ms, Ms, Ms, Ms, Ms, Ha, Ha, Ha, Ha, Ha, Ha, Wwg, Ha, Aa, Ha, Aa, Aa^Vha, Aa^Fpa, Wwg, Ha^Fpa, Aa^Fpa, Re, Ha, Ha, Re, Re, Aa, Re, Ww, Re, Aa, Rb, Rb, Re, Re, Re, Rb, Rb, Re, Ss, Ha^Fma, Re, Ss, Ss, Ss, Wwg, Aa^Fda, Aa^Fma, Aa^Fma, Ss, Aa^Vea, Ss, Aa^Fma
Ms, Ms, Ms, Ha, Ha, Ha, Ha, Ha, Ha, Ha, Ha^Vhha, Ha, Ha, Ai, Wwg, Aa, Ha, Aa, Aa, Ha^Fpa, Wwg, Aa, Rb, Rb, Re, Rb, Re, Rb, Ha, Wwf, Wwf, Wwg^Vm, Aa, Re, Re, Rb, Aa, Rb, Ha^Fpa, Re, Re, Re, Re, Re, Rb, Aa^Fma, Wwg, Wwg, Wwg, Ha^Fma, Wwg, Ha^Fpa, Aa^Fpa, Aa^Fma, Aa
Ms, Ms, Ms^Xm, Ms, Ms^Xm, Ms, Ms, Ha, Ms, Ha, Ha, Ha, Aa, Ha, Wwg, Ai, Wwg, Wwg, Wwg, Ha, Wwf, Aa, Wwg, Ai, Re, Rb, Re, Ha, Aa, Aa, Wwg, Wwf, Wwf, Ha, Wwf, Ha, Ha, Aa, Ss, Ss, Rb, Re, Wwg, Re, Ai, Wwg, Wwg, Ai, Aa^Fma, Wwg, Ha^Fda, Wwf, Ai, Aa^Fpa, Wwg
Ms^Xm, Ms^Xm, Ms^Xm, Ms^Xm, Ms^Xm, Ms^Xm, Ms, Ha, Ha, Ha, Aa, Ha, Ha, Ha, Aa, Rb, Re, Aa, Aa, Wwf, Wwf, Wwg, Aa, Ss, Rb, Re, Ha, Re, Ai, Wwg, Ha, Wwf, Aa, Wwf, Wwf, Aa^Fpa, Wwg, Ha, Wwg, Ha, Rb, Wwg, Wwg, Ai, Ha^Fpa, Aa^Fma, Aa^Fma, Aa^Fma, Aa^Fma, Aa^Fma, Aa^Fma, Wwf, Aa^Fda, Wwg, Aa^Fma
Ms^Xm, Ms^Xm, Ms^Xm, Ms^Xm, Ms, Ms, Ha^Vhha, Ha, Ha, Aa, Ha, Ha, Ha, Rb, Rb, Ha, Ha, Rb, Wwf, Wwf, Ha, Aa, Ss, Ss, Rb, Aa, Rb, Re, Aa, Aa, Aa, Aa, Aa^Fpa, Ha, Wwf, Wwg, Ss, Ss, Aa, Ai, Ai, Aa, Aa, Ha, Ha, Aa^Fma, Ha, Aa^Fma, Aa^Fma, Aa^Fda, Aa, Aa^Fma, Aa^Fda, Aa^Fma, Aa^Fma
Ms, Ms, Ms, Ha, Ms, Ms, Ms, Ms, Ha, Aa, Ha, Ha, Ha, Aa, Ha, Aa, Ss, Ha, Wwf, Aa, Ss, Aa, Ss, Re, Re, Re, Aa, Re, Ss, Rb, Aa, Ha, Wwg, Wwg, Wwf, Ss, Ss, Ss, Ha, Ha, Wwg, Aa, Ha, Ha^Fpa, Aa, Ha^Fpa, Aa, Ha, Aa^Fma, Aa^Fma, Aa^Fma, Aa, Aa^Fda, Aa^Fda, Ha^Fma
Ms, Ms, Ms, Ms, Ms, Ms, Ms, Ha, Ha, Ha, Ha, Aa, Ha, Ha, Ss, Ha, Aa, Ss, Aa, Wwf, Ss, Ss, Rb, Rb, Rb, Rb, Rb, Rb, Ss^Vhs, Ss, Aa, Aa, Wwg, Aa, Wwf, Aa^Fpa, Re, Ha^Fpa, Ha^Fpa, Aa, Ha, Wwg, Wwf, Aa, Ha, Aa, Ai, Aa, Aa^Fpa, Aa^Fpa, Aa^Fma, Aa^Fma, Aa^Fda, Aa^Fda, Aa^Fma
Ms, Ms^Xm, Ms, Wog, Wog, Ha^Vhha, Ha, Ha, Ha, Rb, Rb, Re, Rb, Aa, Ha, Aa, Ss, Ss, Ha, Wwf, Wwf, Ss, Re, Re, Re, Re, Ss, Ss, Ss, Ss, Ha, Wwg, Ss, Ha, Re, Rb, Aa^Fpa, Aa^Fpa, Ha, Ha, Ss, Aa, Wwf, Wwf, Wwg, Ai, Ha, Wwg, Wwg, Wwg, Wwg, Aa^Fma, Aa^Fma, Aa, Ha^Fma
Ms, Ms, Ms, Ms, Ha, Wog, Ha, Ha, Aa, Aa, Aa, Aa, Ss, Aa^Fpa, Aa, Ha^Fpa, Ss, Ss, Ss, Aa, Wwf, Aa, Rb, Ha, Re, Ss, Ss, Ha, Ha, Aa, Ss, Wwg, Ss, Rb, Ha, Aa^Fpa, Aa^Fpa, Ha^Fpa, Aa^Fpa, Ha^Fpa, Aa, Aa, Aa, Wwg, Aa, Aa, Aa, Ha, Aa, Ha, Aa, Wwg, Aa^Fma, Ha^Fma, Aa^Fma
Ha, Ms, Ms, Ms, Wog, Wog, Aa, Aa, Ha, Aa, Aa, Aa^Fpa, Aa^Fpa, Aa^Fpa, Aa^Fpa, Aa, Rb, Rb, Ss, Aa, Wwf, Re, Aa, Rb, Ss, Ss, Aa, Ha, Aa, Ss, Wwg, Wwg, Re, Re, Re, Ss, Ss, Ss, Aa, Ss, Aa, Aa, Aa, Ha, Ha, Aa, Aa^Vaa, Aa, Aa^Fpa, Ha, Aa, Ai, Aa^Fma, Aa^Fma, Wwg
Aa, Ha, Ha, Ha, Wog, Ha, Ha, Aa, Aa, Aa, Ha, Aa^Fpa, Aa, Ss, Ss, Ss, Ss, Re, Ss^Vhs, Ha, Wwf, Re, Rb, Ss^Vhs, Rb, Rb, Aa, Ha, Wwg, Wwg, Ss, Ss^Vhs, Rb, Rb, Ss, Ss, Ha, Aa^Fpa, Aa, Aa, Aa, Aa^Fpa, Aa, Aa^Fpa, Aa, Aa, Aa, Aa, Aa, Aa^Fpa, Aa, Wwg, Wwg, Ai, Wwg
Ha, Ha, Ha, Ha, Wog, Aa, Aa, Ha, Aa, Aa, Ha, Ss, Ss, Ss, Ss, Aa, Ss, Re, Rb, Aa, Wwf, Re, Aa, Rb, Rb, Aa, Ha, Aa, Wwg, Aa, Ss, Rb, Ss, Ha, Aa, Ha, Aa, Aa, Ha, Ha, Aa, Aa, Aa, Ha, Aa^Fpa, Ha, Aa, Aa, Aa, Aa^Fpa, Aa, Aa, Aa, Aa, Aa^Fpa
Aa, Aa, Ha, Aa, Aa, Wog, Wog, Wog, Wwg, Aa, Wwg, Aa, Aa, Aa, Ss, Ss, Ss, Aa, Ha, Ha, Ha, Re, Re, Rb, Aa, Rb, Wwf, Wwg, Ha, Ss, Rb, Re, Aa, Ss, Ha, Aa, Aa, Aa, Aa, Aa, Aa, Aa, Aa^Fpa, Aa^Fpa, Aa, Aa^Fpa, Ha^Fpa, Aa, Aa, Aa, Aa, Aa, Aa^Fpa, Aa, Aa
Aa, Aa, Aa, Aa, Aa, Ha^Fpa, Aa^Fpa, Aa^Fpa, Aa, Wwg, Ha, Wwg, Wwg, Aa, Wwg, Aa, Wwg, Wwg, Wwg, Wwf, Wwf, Wwf, Wwf, Rb, Rb, Rb, Ha, Wwf, Wwf, Ss, Wwf, Ha, Ha, Aa, Ha, Aa, Ha, Ha, Aa, Ha, Aa, Ha, Aa^Fpa, Aa^Fpa, Aa, Aa, Aa, Aa, Aa, Aa, Aa, Aa, Aa, Ha, Aa^Fpa
Aa, Aa, Aa^Fpa, Aa, Aa, Aa, Aa^Fpa, Aa^Fpa, Aa, Aa, Aa, Aa, Aa, Wwg, Aa, Wwg, Ha, Aa, Ha, Aa, Aa, Wwf, Wwf, Rb, Rb, Rb, Aa, Aa, Wwf, Wwf, Wwf, Ha, Wwf, Aa, Wwf, Aa, Ha, Aa, Aa, Ha, Aa^Fpa, Ha, Aa, Aa, Aa, Aa, Ha, Aa, Aa, Aa, Aa, Aa, Aa^Fpa, Aa^Fpa, Aa^Fpa
Aa^Fpa, Aa^Fpa, Aa^Fpa, Aa^Fpa, Aa^Fpa, Aa^Fpa, Aa, Ha, Aa, Aa, Aa, Aa, Aa, Ha, Ha, Ha, Ha, Aa, Aa, Aa, Ha, Re, Rb^Vct, Rb, Rb, Rb, Wwf, Ha, Wwf, Wwf, Aa, Wwf, Aa, Wwf, Aa, Wwf, Wwf, Ha, Aa, Aa, Aa, Ha^Fpa, Aa, Aa, Aa, Ha, Aa, Aa, Aa, Aa^Fpa, Aa, Aa, Aa^Fpa, Aa^Fpa, Aa^Fpa
Aa, Aa^Fpa, Aa^Fpa, Ha^Fpa, Aa^Fpa, Ha, Aa, Aa, Aa, Ha, Aa^Fpa, Aa, Ha, Ha, Aa^Fpa, Aa, Aa, Aa, Ha, Aa, Ha, Re, Re, Rb, Ha, Rb, Rb, Wwf, Re^Vct, Rb, Ha, Ha, Ha, Aa, Aa, Aa, Wwf, Wwf, Aa, Aa, Aa, Aa, Aa, Aa, Ha, Aa, Aa, Aa, Aa, Aa, Ha, Aa, Aa, Ha^Fpa, Aa^Fpa
Ha, Aa, Aa^Fpa, Aa, Aa^Fpa, Aa^Fpa, Aa^Fpa, Ha, Aa, Ha^Fpa, Ha, Ha^Fpa, Ha^Fpa, Ha, Ha^Fpa, Aa, Aa, Aa, Ha, Aa, Rb, Rb, Rb, Aa, Cea, Cea, Cea, Rb, Rb, Rb, Re, Aa, Aa, Ha, Aa, Aa, Ha, Wwf, Wwf, Aa, Ha, Aa, Aa, Aa, Aa, Ha, Wwg, Aa, Wwg, Wwg, Wwg, Wwg, Ai, Aa, Wwg
Aa, Aa, Ha^Fpa, Aa^Fpa, Aa, Aa^Fpa, Aa^Fpa, Ha, Ha, Aa, Ha, Ha, Aa^Fpa, Ha^Fpa, Aa^Fpa, Ha, Aa, Aa, Aa, Re, Rb^Vct, Rb, Rb, Cea, Cea, 1 Kea, Cea, Cea, Ha, Rb, Re^Vct, Ha, Aa, Aa, Aa, Aa, Ha, Aa, Ha, Wwg, Ai, Aa, Wwg, Wwg, Wwg, Wwg, Aa, Ai, Aa, Aa, Aa, Aa, Aa, Ai, Wwg
Aa, Aa, Aa^Fpa, Aa, Ha^Fpa, Aa^Fpa, Ha^Fpa, Aa^Fpa, Aa^Fpa, Aa, Aa, Aa, Aa, Ha^Fpa, Ha, Aa, Aa, Aa, Aa, Aa, Re, Rb, Aa, Rb, Re, Cea, Ha, Rb, Rb, Re, Aa, Ha, Aa, Aa, Aa^Fpa, Aa, Aa, Ha, Aa, Ai, Ha, Ai, Aa, Aa, Ha, Aa, Aa, Aa, Aa, Aa, Aa, Aa, Ha, Aa, Aa
Ha, Aa, Aa, Ha^Fpa, Aa, Aa^Fpa, Ha, Ha^Fpa, Aa, Aa, Aa, Aa, Aa, Ha, Aa, Aa, Aa, Ha, Aa, Aa, Aa, Aa, Aa, Aa, Ha, Aa, Aa, Re, Aa, Re, Aa, Aa, Aa, Aa, Aa^Fpa, Aa^Fpa, Aa, Aa, Ha, Aa, Aa, Aa^Fpa, Aa^Fpa, Aa^Fpa, Ha^Fpa, Aa^Fpa, Aa, Aa, Ha, Aa, Aa, Aa, Aa^Fpa, Aa^Fpa, Aa
Aa, Aa, Ha, Aa, Aa, Aa, Aa, Ha, Aa, Ha, Aa, Ha, Aa, Aa, Aa, Aa, Aa, Aa, Aa, Ha, Aa, Aa, Ha, Aa, Aa, Aa, Aa, Aa, Aa, Aa, Ha, Ha, Ha, Aa, Aa, Aa, Ha, Aa, Ha, Aa, Ha, Aa, Aa, Ha, Ha, Aa, Aa, Aa, Ha^Fpa, Aa, Aa^Fpa, Aa^Fpa, Ha, Aa, Aa
Aa, Aa, Ha, Aa, Ha, Ha, Ha, Ha, Aa, Ha, Aa, Aa, Ha, Aa, Aa, Ha, Aa, Aa, Aa, Aa, Ha, Aa, Ha, Aa, Aa, Aa, Aa, Ha, Aa, Aa, Aa, Aa, Aa, Ha, Ha, Ha, Aa, Aa, Aa, Ha, Aa, Aa, Aa, Aa, Aa, Aa, Aa, Aa^Fpa, Aa, Ha^Fpa, Aa, Aa, Aa, Ha, Aa
