border_size=1
usage=map

Ms^Xm, Ms^Xm, Ms^Xm, Ha^Fpa, Ms^Xm, Aa, Ms^Xm, Ms, Ms, Ms^Xm, Ms, Ms, Ms, Ms, Ms, Ms^Xm, Ms, Ms^Xm, Ms, Ms, Ms, Ms, Ms^Xm, Aa, Ha, Ha, Wog, Wog, Mm, Wog, Mm, Wog, Mm, Mm^Xm, Mm^Xm, Mm, Ms^Xm, Mm^Xm, Ms^Xm, Ms^Xm, Ms^Xm, Aa, Ms^Xm, Mm^Xm, Ms^Xm, Mm, Ms^Xm, Ms^Xm, Ms, Mm^Xm, Mm^Xm, Wog
Ms^Xm, Ms^Xm, Ms^Xm, Ms^Xm, Ms^Xm, Ms^Xm, Ms^Xm, Ms^Xm, Ms^Xm, Ms^Xm, Ms^Xm, Ms^Xm, Ms, Ms^Xm, Ms^Xm, Ms^Xm, Ms^Xm, Ms^Xm, Ms^Xm, Ms^Xm, Ms^Xm, Ms, Ms^Xm, Ha, Ms^Xm, Ms^Xm, Mm^Xm, Mm, Mm, Ms, Mm^Xm, Wog, Mm^Xm, Mm, Mm, Mm^Xm, Mm^Xm, Ms^Xm, Ms^Xm, Ms^Xm, Ms^Xm, Ms^Xm, Ms^Xm, Ms^Xm, Ms^Xm, Mm^Xm, Ms^Xm, Ms, Ms^Xm, Mm^Xm, Mm^Xm, Mm^Xm
Ms^Xm, Ms^Xm, Ms^Xm, Ms^Xm, Ms^Xm, Ms^Xm, Ms^Xm, Ms^Xm, Ms^Xm, Ms, Ms^Xm, Ms, Ms, Ms, Ms^Xm, Ms, Ha, Ms, Ms^Xm, Ms, Ms, Ms^Xm, Ms, Ms^Xm, Ha, Ha, Wog, Mm, Mm, Mm^Xm, Mm, Wog, Mm^Xm, Ms^Xm, Mm^Xm, Mm^Xm, Ms^Xm, Ms^Xm, Ms^Xm, Ms^Xm, Ms^Xm, Ms^Xm, Ms^Xm, Ms^Xm, Ms^Xm, Ms^Xm, Ms^Xm, Ms^Xm, Ms^Xm, Ms, Ms^Xm, Mm^Xm
Ms^Xm, Ms^Xm, Ms^Xm, Ms^Xm, Ms^Xm, Ms^Xm, Ms^Xm, Ms^Xm, Ms^Xm, Ms^Xm, Ms, Ms^Xm, Ms, Ms^Xm, Ms^Xm, Ms^Xm, Ms^Xm, Ms^Xm, Ha, Ms^Xm, Ha, Ms^Xm, Ms^Xm, Ms^Xm, Ms^Xm, Ms^Xm, Mm^Xm, Mm, Mm^Xm, Wog, Wog, Wog, Mm, Mm^Xm, Ms^Xm, Mm, Ms^Xm, Ms^Xm, Ms^Xm, Ms^Xm, Ms^Xm, Ms^Xm, Ms^Xm, Ms^Xm, Ms^Xm, Ms^Xm, Ms^Xm, Ms^Xm, Ms^Xm, Ms^Xm, Mm^Xm, Mm
Ms^Xm, Ms^Xm, Ms, Ms^Xm, Ms^Xm, Ms, Ms^Xm, Ms, Ms^Xm, Ms^Xm, Ms^Xm, Ms, Ms, Ha, Ms^Xm, Ms^Xm, Ha, Ha, Ms^Xm, Ms, Ms, Ms, Ha, Ms, Ms, Ms, Ms, Ms, Mm^Xm, Mm^Xm, Mm, Wog, Mm^Xm, Mm^Xm, Wog, Ms, Ms, Ms^Xm, Ms^Xm, Ms^Xm, Ms^Xm, Ms, Ms^Xm, Ms, Ms^Xm, Ms, Ms^Xm, Ms^Xm, Ms^Xm, Ms^Xm, Ms^Xm, Mm^Xm
Ms, Ms^Xm, Ms^Xm, Ms^Xm, Ms^Xm, Ms^Xm, Ms, Ms^Xm, Ms, Ms^Xm, Ha, Ha, Ha, Ms^Xm, Ha, Ms^Xm, Ha, Ms^Xm, Aa, Ha, Ms^Xm, Ha, Ms, Ms, Ha, Ms, Ms, Ms, Mm^Xm, Mm^Xm, Wog, Wog, Mm^Xm, Ms^Xm, Ms^Xm, Ms, Ms^Xm, Ms^Xm, Ms^Xm, Ms^Xm, Ms^Xm, Ms^Xm, Ms, Ms^Xm, Mm, Mm^Xm, Mm^Xm, Ms^Xm, Ms^Xm, Mm^Xm, Ms, Mm^Xm
Ms^Xm, Ms, Ms^Xm, Ms^Xm, Ms^Xm, Ms^Xm, Ms^Xm, Ms^Xm, Ha^Fda, Ms^Xm, Ha, Ha, Ms^Xm, Ha^Fda, Aa^Fda, Ha, Aa, Ms, Aa, Ha, Aa, Ha^Fda, Ha, Ms, Ha, Ms, Ms, Ms, Mm^Xm, Wog, Wog, Wog, Mm, Mm^Xm, Ms, Ms, Ms, Ms, Ms^Xm, Ms^Xm, Ms^Xm, Ms^Xm, Ms^Xm, Ms^Xm, Ms^Xm, Mm^Xm, Mm^Xm, Mm, Mm, Mm^Xm, Mm^Xm, Mm^Xm
Ms^Xm, Ms^Xm, Ms^Xm, Ms^Xm, Ms^Xm, Ms^Xm, Ha, Ms, Ha^Fda, Ha, Aa, Ms^Xm, Ha, Aa, Ha^Fda, Aa^Fda, Aa, Aa, Aa, Aa, Ha^Fda, Aa^Fda, Aa, Ha, Ms, Ms, Ms, Mm^Xm, Mm, Mm^Xm, Wog, Mm^Xm, Mm^Xm, Ms, Ms, Ms, Ms, Ms, Ms, Ms, Ms^Xm, Ms, Ms^Xm, Ms, Ms, Ms, Wog, Ms, Ms^Xm, Ms, Mm^Xm, Mm^Xm
Ms^Xm, Ms^Xm, Ms^Xm, Ms^Xm, Ms^Xm, Ms^Xm, Ha, Ha, Ha, Aa^Fda, Aa^Fda, Aa, Ha, Aa, Aa, Aa^Fda, Aa, Ha, Gs, Aa, Aa^Fda, Aa, Aa, Ms^Xm, Ms, Ms, Ha, Mm^Xm, Mm, Wog, Wog, Mm, Mm^Xm, Ms^Xm, Ms, Ms, Ha, Ms, Ha, Ms, Ms, Ms, Ms, Ms, Ms, Ms, Wog, Mm^Xm, Ms^Xm, Mm^Xm, Ms, Mm^Xm
Ms^Xm, Ms^Xm, Ms^Xm, Ms^Xm, Ms, Ha, Ms^Xm, Aa, Aa, Aa^Fda, Aa, Aa^Fda, Hh, Aa, Hh^Fmw, Gs, Hh^Fmw, Ha^Fmw, Aa^Fma, Gs^Efm, Aa^Fda, Aa^Fda, Aa, Aa, Gg, Mm, Mm^Xm, Mm, Mm^Xm, Wog, Wwf, Mm^Xm, Ms^Xm, Ms, Ms, Ha, Ms, Ha, Ha, Ms, Ha, Ms, Ms, Ms, Ms, Ms, Mm^Xm, Mm, Ms, Mm^Xm, Mm, Wog
Ms, Mm, Ms^Xm, Ha, Ha, Ms, Ms^Xm, Aa^Fda, Aa, Aa, Aa^Fma, Gs, Aa, Hh^Fmw, Wwf, Aa, Gs, Aa^Fma, Gs, Gs, Gg, Gs, Gg^Efm, Gg^Efm, Gg, Mm^Xm, Mm^Xm, Ms, Wog, Wog, Mm^Xm, Ms^Xm, Ms, Ms, Ha^Fda, Ha^Fda, Ha^Fda, Ha^Fda, Aa, Ha^Fda, Aa, Ha, Ha, Ms, Ms, Mm, Mm^Xm, Ms^Xm, Ms, Ms, Wog, Mm^Xm
Ms, Ms, Ms, Ms, Ha, Ms^Xm, Ms^Xm, Ms^Xm, Ha, Ha^Fmw, Ha^Fmw, Hh, Gg, Gg^Efm, Aa, Aa, Gg, Aa, Ha, Hh, Gg, Gg^Efm, Gg, Gg^Efm, Gg^Efm, Mm, Gs, Wog, Wog, Wog, Wog, Wog, Mm, Ha, Ha, Ha, Ha^Fda, Aa, Ha, Aa^Fda, Aa, Ms, Aa, Ms, Ms, Ms, Ms, Mm^Xm, Mm^Xm, Mm^Xm, Mm^Xm, Wog
Mm^Xm, Ha^Fpa, Ms, Ha, Ms, Aa^Fda, Aa, Aa, Gs, Aa, Ha^Fmw, Hh^Fmw, Ha^Fmw, Wwf, Ha^Fmw, Gg, Aa^Fma, Gg, Gg, Gg, Ha, Gs, Hh, Gg^Efm, Aa^Fma, Gg, Wwf, Wog, Wog, Wwg, Ms, Mm, Ms, Aa, Aa, Aa, Aa^Fda, Aa, Gs, Aa, Gs, Aa, Aa^Fda, Ms, Aa, Ms, Ha, Ms^Xm, Ms^Xm, Mm^Xm, Ms, Ms
Mm^Xm, Ms, Ms^Xm, Ms, Ha^Fpa, Aa^Fda, Aa^Fda, Aa, Aa, Aa, Gs^Efm, Aa^Fma, Aa, Aa^Fma, Aa^Fma, Aa^Fma, Wwf, Gll^Fmw, Gs, Gs, Gg, Gs, Ha, Gs^Vh, Wwf, Gs, Wwf, Wog, Wog, Wwf, Aa, Ms, Mm, Gs, Gg, Aa^Fda, Ha^Fmw, Aa, Aa^Fda, Gll^Fmw, Gll^Fmw, Aa^Fda, Aa^Fda, Aa, Wog, Aa, Wog, Ha, Ms, Ms, Ms^Xm, Ms^Xm
Wog, Wog, Ms^Xm, Ms, Mm, Aa, Aa, Gs^Efm, Aa, Aa, Gs^Vh, Gs^Efm, Aa, Aa, Wwf, Gg, Gg, Gg, Gs, Hh, Gs^Efm, Gs, Hh, Aa^Fma, Hh, Wwf, Wog, Wog, Wog, Wog, Gg, Gs^Vh, Aa^Fma, Aa, Gg^Efm, Gs, Gs, Gll^Fmw, Aa^Fda, Gs, Gg, Aa, Aa, Wwg, Aa, Aa, Aa, Ha^Fda, Ha^Fda, Ms^Xm, Ms, Mm^Xm
Ms^Xm, Wog, Wwg, Ms^Xm, Mm, Gs, Gs^Efm, Gs^Efm, Aa^Fma, Gll^Fmw, Hh^Fmw, Gs, Ha^Fmw, Gll^Fmw, Aa, Gg^Efm, Gg^Efm, Hh, Gs^Vh, Gs, Chr, Gs, Gs, Gg, Gg, Aa^Fma, Wog, Wog, Wog, Wwf, Wwf, Hh, Hh, Gg, Gs, Aa, Wwf, Hh^Fmw, Aa, Aa, Gg^Efm, Gs, Wwg, Wwg, Gs^Efm, Gs, Gg, Aa^Fda, Ms, Ha^Fda, Ms, Mm^Xm
Ms^Xm, Mm^Xm, Wwg, Ms, Ms, Ha, Wwg, Aa, Gs, Ha^Fmw, Ha^Fmw, Aa^Fma, Gs, Wwf, Gg, Gg^Efm, Gg^Efm, Aa^Fma, Chr, Gg, Gs, Hh^Fmw, Chr, Gg^Efm, Gg^Efm, Hh, Wwf, Wwg, Wog, Gll^Fmw, Wwf, Aa, Gg^Efm, Gg, Hh, Gg, Gs, Wwf, Aa, Gg, Gg^Efm, Ss, Wwg, Wwf, Gs, Hh, Hh, Aa, Aa, Ha, Ms, Mm
Mm, Ms, Ha, Wwg, Wwg, Wwg, Hh, Ha, Wwf, Rb, Aa, Hh, Wwf, Hh, Gg, Gg^Efm, Chr, Gs, Chr, Chr, Khr, Chr, Chr, Gs, Chr, Ha, Ha^Fmw, Wwg, Wog, Wwf, Gg, Gs^Efm, Gg, Gs, Gll^Fmw, Hh, Gg, Wwf, Aa^Fma, Hh^Fmw, Gg, Aa, Wwg, Gs, Wwf, Gs^Vh, Gs, Gg, Gs, Aa^Fda, Ha, Ha
Ms, Ms, Aa, Ha^Fda, Gs, Md, Aa, Wwf, Aa, Gll^Fmw, Hh, Gg, Gg^Efm, Hh, Aa, Gg, Gg, Hh, Khr, Gg, Chr, Gg, Khr, Gs, Gg^Efm, Hh, Wwf, Aa, Wwg, Wog, Wog, Gs^Efm, Gg^Efm, Gll^Fmw, Hh, Hh^Fmw, Gs, Gg^Efm, Gg, Hh^Fmw, Gg, Wwg, Ss, Wwg, Gs^Efm, Gs^Efm, Wwf, Ha^Fmw, Gs^Efm, Aa, Aa^Fda, Mm
Mm, Aa, Aa^Fda, Aa, Aa, Gs^Vh, Wwf, Wwf, Aa^Fma, Hh, Gg^Efm, Gg^Efm, Aa, Aa, Gs, Gg^Fet, Gg, Chr, Wwf, Chr, Khr, Chr, Aa, Chr, Gg^Efm, Gg, Wwf, Ha^Fmw, Wwf, Wog, Wog, Wwf, Aa, Gs, Gg, Gll^Fmw, Gg, Gg, Aa, Ha^Fmw, Gg, Gs, Aa^Fma, Gs, Ha^Fmw, Wwf, Aa^Fma, Ha^Fmw, Gs^Vh, Aa, Aa, Aa^Fda
Aa, Ha, Aa, Aa, Wwf, Wwf, Gs^Efm, Gs, Gg^Efm, Gll^Fmw, Gg^Efm, Gg, Gs^Vh, Hh, Hh, Gg, Aa^Fma, Chr, Khr, Chr, Chr, Chr, Khr, Chr, Gs^Efm, Gg^Efm, Gg, Gg^Fet, Gll^Fmw, Wog, Wog, Aa^Fma, Gg, Gg^Efm, Gg^Efm, Gg^Efm, Gg^Efm, Gg^Efm, Gg, Gg, Aa, Aa, Gs, Ha^Fmw, Gg, Gg, Hh^Fmw, Gs, Gs^Efm, Gs^Efm, Aa, Aa^Fda
Ha, Aa^Fda, Aa, Aa, Wwf, Gg, Gs^Efm, Gs^Efm, Gg, Gg, Gs, Aa, Wwf, Gs, Aa^Fma, Gg, Chr, Aa^Fma, Chr, Hh, Khr, Gg, Chr, Hh^Fmw, Chr, Hh, Gs, Gg^Efm, Aa^Fma, Wog, Wog, Gs^Vh, Wwf, Gs, Aa, Gg, Hh, Wwf, Gg, Gg, Wwf, Aa^Fma, Aa^Fma, Wwf, Gg, Gs, Wwf, Gs^Efm, Mm, Gs, Aa, Aa^Fda
Ha, Aa^Fda, Gs, Aa, Wwf, Gs^Efm, Gg^Efm, Hh, Gg, Wwf, Hh, Aa, Gll^Fmw, Gg, Gg, Gg, Gg, Ha^Fmw, Chr, Chr, Gg, Chr, Chr, Gs^Efm, Hh, Wwf, Gg, Gg^Efm, Gg, Wwf, Wwf, Wog, Aa, Wwf, Gs, Hh, Gg^Fet, Gg, Gs, Gs^Vh, Gs, Ha^Fmw, Gg^Efm, Gg^Efm, Hh^Fmw, Gs, Mm, Mm, Mm, Aa, Aa, Aa
Aa, Aa, Gs^Efm, Rb, Aa^Fma, Gg, Gg, Wwf, Gg, Gs, Gs, Hh, Gg, Gs, Gg^Efm, Aa, Aa, Aa^Fma, Gs^Efm, Gg^Efm, Chr, Gg^Efm, Gg^Efm, Gs^Efm, Gg, Wwf, Aa, Wwf, Gg, Wwf, Aa, Wog, Wog, Aa, Aa, Gs, Aa^Fma, Gs, Gs, Aa^Fma, Gg, Wwf, Gs^Efm, Gs, Gs, Aa, Gs, Aa, Mm, Ha, Aa, Mm^Xm
Aa^Fda, Aa, Gs^Efm, Aa, Wwf, Wwf, Aa^Fma, Gs, Gg, Hh^Fmw, Wwf, Aa^Fma, Gs, Gg^Efm, Gs^Efm, Aa, Gs^Vh, Gs^Efm, Gg, Gll^Fmw, Gs, Gg, Gg^Efm, Gs^Efm, Gll^Fmw, Wwf, Gs, Gll^Fmw, Gg^Efm, Gs, Gs, Wwf, Wog, Wwf, Gs, Gg, Gs, Aa^Fma, Hh^Fmw, Aa^Fma, Aa, Gs, Aa, Hh^Fmw, Gg^Efm, Wwf, Gs, Aa, Gs, Aa, Aa^Fda, Ms^Xm
Aa, Aa, Gs, Gs^Efm, Ha^Fmw, Aa, Aa^Fma, Hh, Aa^Fma, Gs, Wwf, Gs, Hh^Fmw, Gg, Gs^Efm, Gll^Fmw, Gg, Gg^Efm, Aa^Fma, Aa, Gs, Hh, Gg, Gg^Efm, Gg, Hh^Fmw, Gs^Efm, Wwf, Gg, Gs^Efm, Gs^Efm, Gll^Fmw, Wog, Gg, Gs, Aa, Gg, Ss, Ss, Ha^Fmw, Gg^Efm, Wwf, Gg, Gg^Efm, Gs^Efm, Gs^Efm, Hh^Fmw, Aa^Fma, Gs^Efm, Gs, Ms^Xm, Ms^Xm
Aa^Fda, Aa^Fda, Aa, Gs^Efm, Wwf, Aa^Fma, Wwf, Gll^Fmw, Aa^Fma, Gs, Hh, Aa^Fma, Gg, Gg, Gs^Efm, Gg^Efm, Gs^Efm, Gs^Efm, Gs, Wwf, Aa^Fma, Gs, Gs, Gll^Fmw, Gs, Gs, Hh^Fmw, Wwf, Wwf, Gg, Wwf, Gs, Gg, Wog, Gs^Vh, Wwg, Gs, Wwg, Ha^Fmw, Gg, Wwf, Gs^Efm, Gg, Aa^Fma, Ha^Fmw, Gs, Gll^Fmw, Aa^Fma, Gs^Efm, Aa, Ms^Xm, Mm^Xm
Ha^Fda, Aa, Aa, Gs, Gs, Aa^Fma, Gg, Gs, Gg, Gg, Aa, Aa, Aa, Gg^Efm, Gs, Gg, Aa, Aa, Wwf, Hh, Hh^Fmw, Gll^Fmw, Gg, Gg^Efm, Gs, Aa, Gs, Gg^Efm, Gs, Hh^Fmw, Wwf, Wwf, Aa^Fma, Wog, Wog, Wwg, Gs, Ss, Gg, Gg^Efm, Gg, Gg, Aa^Fma, Wwf, Ha^Fmw, Ha^Fmw, Aa, Ha^Fmw, Gs^Efm, Aa, Aa^Fda, Ms^Xm
Aa, Aa, Aa^Fda, Aa, Aa, Hh^Fmw, Ha^Fmw, Wwf, Hh^Fmw, Hh, Gs^Efm, Gs, Ha^Fmw, Gs, Wwf, Ha^Fmw, Gg, Aa, Gs^Efm, Gs^Efm, Gll^Fmw, Hh^Fmw, Gg, Gg^Efm, Gg^Efm, Hh^Fmw, Wwf, Gs, Hh, Ha^Fmw, Wwf, Aa^Fma, Wwf, Wog, Gs, Gg, Gs^Efm, Gs, Gg^Efm, Gs, Gg, Aa^Fma, Gg, Gg, Gg, Wwf, Gg^Efm, Gs^Efm, Gs, Aa^Fda, Aa^Fda, Ms
Ha, Ha^Fda, Aa^Fda, Gs, Aa, Wwf, Wwf, Gg, Wwf, Gs, Gs^Efm, Wwf, Aa^Fma, Rb, Gs, Gs, Gs, Gs^Vh, Wwf, Gs^Efm, Gg^Efm, Gs, Wwf, Gs^Efm, Gs, Gs, Gs, Hh^Fmw, Wwf, Wwf, Gg, Aa, Wog, Wog, Wwf, Gg, Gg, Gs^Vh, Gs, Gg^Efm, Gs^Efm, Gs^Efm, Gs^Efm, Gg^Efm, Gg^Efm, Gg^Efm, Gs, Gg, Aa, Gs, Aa, Aa^Fda
Ha, Ha^Fda, Aa, Aa, Gs, Gg, Gs^Vh, Gs, Hh^Fmw, Aa^Fma, Aa, Aa, Aa^Fma, Aa^Fma, Gll^Fmw, Aa^Fma, Aa^Fma, Gs, Gg, Wwf, Wwf, Wwf, Aa, Hh, Gs, Gs^Efm, Chr, Ha^Fmw, Rb^Edt, Gg, Gs, Gs, Wog, Wog, Wwf, Ha^Fmw, Gs, Gs^Efm, Gg^Efm, Gs, Wwf, Gg, Ha^Fmw, Gs, Wwf, Wwf, Wwf, Gs, Ha^Fmw, Gs, Ha, Aa^Fda
Ms, Aa, Aa^Fda, Aa^Fda, Aa, Gs, Wwf, Aa, Aa, Gs, Wwf, Gs, Gs, Wwf, Gg, Gg, Aa^Fma, Gg, Wwf, Wwf, Wwf, Gs, Gs, Gg^Efm, Chr, Hh^Fmw, Chr, Gs^Vh, Chr, Wwf, Hh, Gg, Wog, Wwf, Chr, Chr, Chr, Gs^Efm, Gll^Fmw, Gg, Gg, Gs, Aa^Fma, Ha^Fmw, Gs, Ha^Fmw, Gg, Hh^Fmw, Aa, Gs, Ha^Fpa, Ms^Xm
Ms, Ms, Ha^Fda, Aa^Fda, Aa, Gs, Hh^Fmw, Gll^Fmw, Gs, Rb, Aa, Aa, Gg, Gll^Fmw, Gg^Efm, Gg^Efm, Chr, Chr, Chr, Aa^Fma, Aa^Fma, Gs^Vh, Wwf, Gs^Efm, Chr, Chr, Chr, Chr, Chr, Aa, Wwf, Wog, Hh^Fmw, Hh^Fmw, Chr, 5 Khr, Chr, Gs^Efm, Wwf, Gs, Ha^Fmw, Gg, Gs, Ha^Fmw, Aa^Fma, Gg, Aa, Gs, Aa, Ha, Ms^Xm, Aa
Aa, Ms, Ha, Aa, Aa^Fda, Gs, Ha^Fmw, Wwf, Gs^Efm, Hh^Fmw, Wwf, Aa^Fma, Gg, Gg, Gg^Efm, Gg, Chr, 4 Khr, Chr, Aa^Fma, Aa, Gg, Gg, Chr, Chr, Gs, 3 Khr, Gs, Chr, Chr, Wwf, Wog, Aa^Fma, Gg, Aa, Chr, Aa^Fma, Gg, Gg, Wwf, Wwf, Gg, Gg, Hh^Fmw, Wwf, Aa^Fma, Gs, Gg, Gs, Wwg, Ha^Fpa, Ms^Xm
Aa, Ha, Aa, Aa^Fda, Aa, Aa^Fma, Ha^Fmw, Ha^Fmw, Gs, Gs, Gg^Efm, Gg, Wwf, Gg^Efm, Aa, Wwf, Gg, Chr, Wwf, Gg, Gg^Efm, Gg, Gs, Gg^Fet, Chr, Chr, Hh^Fmw, Chr, Chr, Hh^Fmw, Wwf, Wog, Gg, Gg^Efm, Aa, Aa, Gg, Gg, Ha^Fmw, Gs, Gs, Wwf, Wwf, Aa, Aa, Gs, Ha^Fmw, Hh^Fmw, Aa, Ha^Fda, Ha^Fpa, Ms^Xm
Aa^Fda, Aa, Aa^Fda, Aa, Aa, Aa^Fma, Aa, Aa^Fma, Aa, Gg, Gg, Gg, Aa^Fma, Gs, Ha^Fmw, Wwf, Wwf, Wwf, Gg^Efm, Gg^Efm, Wwf, Gg, Aa^Fma, Chr, Gg^Efm, Chr, Chr, Chr, Aa^Fma, Chr, Wwg, Wog, Gs^Efm, Gs, Gg, Gg, Gg^Efm, Aa^Fma, Wwf, Gs, Gll^Fmw, Aa^Fma, Aa^Fma, Aa^Fma, Ha^Fmw, Aa^Fma, Aa^Fma, Gs, Aa, Ms^Xm, Ms^Xm, Ms^Xm
Aa^Fpa, Aa^Fda, Aa^Fda, Aa, Gs, Aa, Gs, Aa^Fma, Gs, Gg^Efm, Gg^Efm, Gg, Gs, Aa, Gs^Vh, Gs, Gg, Gg^Efm, Aa, Gg, Gg^Efm, Gg, Aa^Fma, Aa, Gg^Efm, Chr, Gg, Chr, Aa^Fma, Gg, Wwg, Wog, Gg^Efm, Gs^Efm, Gg^Efm, Aa, Gg, Gg, Wwf, Gs, Gs, Wwf, Gs, Wwf, Ha^Fmw, Aa, Aa, Aa^Fda, Aa^Fda, Aa^Fda, Aa^Fda, Aa
Aa, Aa, Aa, Aa, Aa, Gs, Gg^Efm, Gs^Efm, Wwf, Gs, Wwf, Wwf, Ha^Fmw, Aa, Wwf, Aa, Gg, Gg^Efm, Gg^Efm, Gg^Efm, Aa^Fma, Gs, Aa, Aa, Gg, Gg^Efm, Aa, Aa, Aa, Aa, Gg, Wog, Gg, Gs^Efm, Gs, Gs, Gg, Gg^Efm, Gg^Efm, Gg^Efm, Gg^Efm, Hh^Fmw, Gs^Vh, Wwf, Gs, Gg, Gs, Gs, Aa, Aa^Fda, Aa, Aa^Fda
Gs^Fp, Aa, Aa, Aa, Aa, Gs, Gg^Efm, Gs^Efm, Aa, Aa, Wwf, Aa, Gs, Wwf, Gs^Efm, Wwf, Wwf, Gg^Efm, Gs^Efm, Gg, Wwf, Gg, Gg, Gs, Wwf, Gg, Gg, Gg, Aa^Fma, Gg^Efm, Gg^Efm, Wog, Wog, Aa^Fma, Wwf, Gs, Gs, Aa, Gg^Efm, Gg^Efm, Gg^Efm, Gg, Gs, Wwf, Gs^Efm, Gs, Gs^Efm, Aa, Gs, Aa, Aa^Fda, Aa^Fda
Hh, Gs^Fdw, Gs^Fdw, Gs, Aa, Aa, Gs, Gs^Efm, Gs, Wwf, Aa, Hh^Fmw, Hh^Fmw, Gs^Efm, Wwf, Gg, Gs, Gg^Efm, Gs, Aa, Aa, Aa^Fma, Aa, Aa^Fma, Aa^Fma, Aa^Fma, Gg^Efm, Gs^Vh, Gs, Gg, Gg^Efm, Wwf, Wog, Wwg, Wwf, Ha^Fmw, Gg, Gg^Efm, Gg, Aa, Gg, Gs^Efm, Wwf, Gg^Efm, Gg^Efm, Gs^Efm, Gs, Gg, Aa, Aa, Ms^Xm, Aa^Fda
Ms, Hh, Ha^Fpa, Gs, Gs, Aa, Aa, Aa, Gs, Gs, Wwf, Ha^Fmw, Aa, Gg^Efm, Gs^Efm, Ha^Fmw, Wwf, Gg^Efm, Gg^Efm, Aa^Fma, Aa, Gg, Gg^Efm, Aa^Fma, Gs, Aa^Fma, Gg^Efm, Gg, Aa^Fma, Aa, Gg, Wwf, Gll^Fmw, Wog, Wwg, Ha^Fmw, Gs, Gs, Gg, Aa^Fma, Gs, Gs^Efm, Wwf, Gs^Efm, Gs, Gs^Efm, Gs, Ha^Fpa, Ha^Fda, Ha, Ms^Xm, Aa
Ms, Ms, Ms, Ha^Fpa, Gs, Aa, Aa, Aa, Gs, Gs, Wwf, Hh^Fmw, Gs^Efm, Wwf, Gs^Efm, Wwf, Gg^Efm, Gg, Gs^Efm, Gg^Efm, Gg, Wwf, Wwf, Gg^Efm, Aa, Hh^Fmw, Gs, Gs^Efm, Gg^Efm, Gs, Aa^Fma, Gg, Wwf, Wog, Wwg, Wwf, Ha^Fmw, Gg, Gg^Efm, Aa, Wwf, Gs, Gs, Hh^Fmw, Aa, Gs, Ha, Hh, Ha^Fda, Ha, Ms, Ms^Xm
Ms^Xm, Ms, Mm, Ha^Fpa, Gs, Gs, Gs, Gs, Aa, Aa, Aa, Wwf, Aa, Wwf, Wwf, Gg^Efm, Gg^Efm, Hh^Fmw, Aa^Fma, Gll^Fmw, Gs^Efm, Wwf, Aa, Wwf, Aa^Fma, Ha^Fmw, Gs, Wwf, Gg, Gs, Aa, Gg, Wwf, Wog, Wwg, Ha^Fmw, Hh^Fmw, Gs, Gg, Gg^Efm, Wwf, Aa^Fma, Aa^Fma, Aa, Gg, Gs, Ha^Fpa, Ha, Mm, Mm, Mm, Ms
Ms^Xm, Ms, Ms, Hh, Gs, Gs^Fmw, Gs, Gs^Efm, Gs^Efm, Aa, Aa, Gg^Efm, Gs^Efm, Gg^Efm, Aa, Gg, Gg, Gs, Aa, Gs^Efm, Wwf, Gs, Aa, Aa^Fma, Gg^Efm, Gs, Aa^Fma, Gs, Gg^Efm, Gg, Gs, Gs, Wwf, Wog, Wog, Gs, Wwf, Wwf, Gg, Gg^Efm, Gg, Gs, Aa, Gs, Gs, Ha, Ha^Fpa, Ha, Mm, Mm, Ms, Ms^Xm
Mm^Xm, Mm, Ms, Mm, Gs, Gs, Gs^Fp, Gs, Gs, Aa, Gs, Aa, Aa, Aa, Gs, Aa, Wwf, Aa, Gg, Gs^Efm, Aa^Fma, Gg^Efm, Gg, Gg^Efm, Gg^Efm, Gs^Efm, Gg^Efm, Gg, Gg^Efm, Gg, Gs, Gs, Gs, Wwg, Wog, Wwf, Aa^Fma, Wwf, Wwf, Wwf, Gg, Gg^Efm, Gs, Gs^Efm, Gs, Ha^Fpa, Ha, Mm, Ms, Ms, Mm^Xm, Mm^Xm
Ms, Ms, Ha, Ha^Fda, Gs, Gs, Hh, Gs, Ss, Gs, Gs^Efm, Gg, Gs, Gs^Efm, Gs^Efm, Aa, Wwf, Wwf, Aa, Gs^Efm, Gll^Fmw, Wwf, Gg^Efm, Gg^Efm, Wwf, Gg, Wwf, Gs, Wwf, Gg^Efm, Gs^Efm, Aa^Fma, Gs, Wwg, Wog, Wwf, Gs, Gs, Wwf, Gs, Aa, Gg, Aa, Gs^Efm, Aa, Ha^Fda, Ha, Ha, Ms^Xm, Mm^Xm, Ms^Xm, Mm^Xm
Mm, Hh, Hh^Fda, Ha^Fda, Gs, Gs^Fmw, Gs^Fmw, Ss, Wwf, Aa, Gs, Gs^Efm, Hh, Gs, Gs^Efm, Gs, Gs, Wwf, Gs, Aa, Gs, Aa, Gs, Gs, Aa, Aa, Wwf, Aa, Aa, Gg^Efm, Gg^Efm, Gg, Wwf, Wwf, Wwg, Wog, Aa, Gll^Fmw, Gs, Gs, Gs^Efm, Gs, Gg, Gs, Aa, Aa, Mm, Mm, Ms^Xm, Ms^Xm, Ms^Xm, Gs^Fp
Gs^Fp, Gs^Fmw, Gs^Fmw, Gs^Fp, Gs, Ss, Ss, Wwf, Wwf, Gs^Fp, Gs, Gs^Efm, Ha, Mm, Gs, Gs^Efm, Aa, Wwf, Gs, Aa^Fma, Aa, Gs, Aa, Gg, Aa, Wwf, Gs, Gs, Aa, Gs, Gg^Efm, Aa, Wwf, Gs, Gs^Efm, Wog, Gs, Aa, Gg, Gs^Efm, Aa, Gg^Efm, Aa, Aa, Ha^Fpa, Ha, Ms, Ms, Ms^Xm, Mm^Xm, Ms, Ms
Gs^Fp, Aa, Gs^Fmw, Gs^Fmw, Ss, Wwg, Wwg, Ss, Wwg, Wwf, Gs, Gs, Gs, Mm, Mm, Gs, Gs, Aa, Gs, Aa, Aa, Gs, Gs, Aa, Gs^Efm, Gg^Efm, Gs^Efm, Gs, Aa^Fma, Aa, Gs^Efm, Gg^Efm, Gs, Gg^Efm, Gs^Efm, Wog, Ss, Gs, Gs, Aa^Fma, Aa, Gs, Aa^Fma, Gs, Aa, Ms, Mm, Ms, Ms^Xm, Mm^Xm, Ms, Ms
Hh^Fp, Gs^Fp, Gs, Wwf, Wwg, Ss, Wwg, Wwg, Ss, Wwf, Gs, Ha, Gg, Hh, Ha, Mm, Gs, Gs, Ha^Fda, Gs, Gs^Efm, Gs, Gs^Efm, Gs^Efm, Gs, Gs, Aa^Fma, Gs^Efm, Gs^Efm, Aa, Gs, Gg^Efm, Gg^Efm, Aa, Gs^Efm, Wwg, Wwg, Ss, Gs^Efm, Aa, Aa^Fma, Gg, Gs^Efm, Gs^Efm, Gs, Mm, Mm, Ms, Mm^Xm, Ms, Ms^Xm, Ms
Mm, Mm, Ha^Fda, Wwg, Gs^Fmw, Wwg, Wwf, Ss, Gs, Gs, Gs^Fp, Gg, Gs^Fp, Gs, Gs, Ha^Fda, Gs, Gs, Gs^Efm, Gs^Efm, Gg, Gs^Efm, Aa, Aa^Fma, Aa, Gg, Gg, Aa, Aa, Gg, Gg, Gs^Efm, Gg, Gg^Efm, Gs, Gg^Efm, Gs^Efm, Wwg, Wwg, Gs^Efm, Gg, Gs^Efm, Aa, Gg^Efm, Gs, Gs^Fdw, Mm, Mm^Xm, Ms^Xm, Ms, Ms^Xm, Ms
Ms, Ms, Mm, Wog, Ha^Fpa, Gs^Fmw, Gs^Fmw, Gs, Gs^Fp, Gs, Gs, Gs, Gs, Gs, Gs^Fp, Gs, Gg, Gs^Efm, Gg, Gs, Aa^Fma, Aa, Aa^Fma, Aa, Gg, Aa^Fma, Gs, Aa, Aa, Aa, Aa^Fma, Gs, Aa, Aa, Gs^Fp, Gs, Hh, Gs^Efm, Wwg, Gs^Efm, Gs^Ve, Gs, Gs, Gs, Ha, Gs^Fdw, Mm, Ms^Xm, Mm, Ms, Ms, Ms
Ms, Mm, Mm, Wog, Mm, Ha^Fpa, Ha, Gs^Fp, Gs, Gs, Aa, Aa, Aa^Fpa, Aa, Gs, Gs, Gs, Gg, Gs, Aa^Fma, Gs, Aa, Aa, Gg, Aa, Gs, Aa^Fma, Gs, Gs, Gg, Gs, Gg, Gs, Gs, Hh^Fmw, Hh, Ha^Fpa, Ha^Fpa, Wog, Wog, Hh, Ha^Fpa, Hh, Hh, Mm, Ms^Xm, Ms^Xm, Mm^Xm, Ms^Xm, Ms, Ms^Xm, Ms^Xm
Ms^Xm, Ms, Ms, Wog, Mm, Ha^Fda, Ha, Gs^Fp, Gs, Aa, Aa^Fpa, Aa^Fpa, Aa, Aa^Fp, Gs^Fmw, Gs^Fp, Gs^Fp, Gs^Fmw, Gs, Gs, Aa^Fda, Gs, Aa^Fma, Gs, Aa^Fma, Gs, Gg^Efm, Gs, Aa^Fma, Gs, Aa, Gs, Hh^Fmw, Hh^Fmw, Hh, Ha^Fpa, Mm, Ha, Mm, Wog, Mm, Ha, Mm, Mm, Ms^Xm, Ms^Xm, Ms^Xm, Mm^Xm, Ms, Ms, Ms, Ms
Ms^Xm, Ms^Xm, Mm^Xm, Ms, Ms, Hh, Hh, Hh, Gs^Fp, Gs^Fp, Aa, Gs^Fp, Gs^Fp, Gs, Hh, Gs^Fmw, Gs, Gs^Fp, Gs^Fp, Aa, Aa^Fda, Gg, Gg, Aa^Fma, Gg, Gg, Gg^Efm, Gs, Aa, Aa, Gs^Fp, Gs^Fmw, Hh, Hh, Ha^Fda, Ha, Mm, Mm, Mm, Wog, Wog, Mm, Mm^Xm, Mm^Xm, Ms^Xm, Ms^Xm, Ms, Ms, Mm^Xm, Mm^Xm, Ms, Mm^Xm
Mm^Xm, Ms^Xm, Mm, Mm, Ms, Mm, Mm, Ha^Fda, Gs, Gs^Fp, Gs, Gs^Fmw, Hh, Hh, Ha, Gs^Fp, Ha^Fda, Gs^Fmw, Gs^Fp, Gs^Fp, Aa^Fda, Aa, Gs, Gs, Aa, Gs, Gs, Gs, Gs^Fmw, Gs^Fmw, Gs, Hh, Ha^Fda, Ha^Fda, Hh, Mm, Ms, Ms, Mm^Xm, Mm^Xm, Mm^Xm, Mm^Xm, Mm^Xm, Ms^Xm, Ms, Mm^Xm, Ms, Ms^Xm, Ms, Ms^Xm, Ms, Ms
Mm^Xm, Mm^Xm, Mm^Xm, Mm, Mm, Mm, Hh, Ha^Fda, Gs, Gs^Fp, Gs, Ha, Hh, Hh, Hh, Ha^Fda, Hh^Fp, Ha^Fda, Hh^Fp, Hh, Gs, Gs, Gs, Aa, Gs^Fmw, Gs^Fp, Gs^Fmw, Gs^Fmw, Gs^Fmw, Gs^Fdw, Hh, Hh^Fp, Hh, Ha, Ha^Fda, Mm, Mm, Mm^Xm, Ms, Mm^Xm, Ms, Ms, Ms, Mm^Xm, Ms^Xm, Ms, Ms, Ms, Ms^Xm, Ms^Xm, Ms, Ms
Mm^Xm, Mm^Xm, Ms^Xm, Mm, Mm^Xm, Hh, Ms, Gs, Ha, Gs, Hh, Hh, Gs^Fp, Gs, Gs, Hh, Gs^Fmw, Gs^Fmw, Hh^Fmw, Gs, Hh^Fp, Gs^Fp, Gs^Fmw, Gs^Fmw, 1 Hh^Fp, Gs, Gs^Fp, Gs, 2 Hh^Fp, Hh, Gs^Fmw, Gs, Hh, Gs, Aa^Fdw, Gs, Ms^Xm, Ms, Ms^Xm, Ms^Xm, Mm^Xm, Mm^Xm, Ms^Xm, Ms, Ms, Ms^Xm, Ms^Xm, Ms^Xm, Ms^Xm, Ms^Xm, Ms, Ms
Mm^Xm, Mm^Xm, Mm^Xm, Mm^Xm, Mm^Xm, Mm^Xm, Mm, Ms, Gs, Hh, Gs, Gs^Fp, Gs, Ha, Mm, Gs, Gs, Hh, Hh, Hh, Hh, Gs, Gs, Gs, Gs, Hh, Gs^Fp, Gs, Gs, Hh^Fmw, Gs, Hh, Gs, Gs^Fmw, Gs^Fmw, Ms^Xm, Gs^Fmw, Ms, Ms, Ms, Ms, Ms, Ms, Ms, Gs, Ms, Ms, Ms, Ms, Ms, Ms, Ms
