border_size=1
usage=map

Aa, Aa, Aa, Aa, Aa, Aa, Ha, Ha, Ha, Aa, Ha, Aa, Ha, Aa, Aa, Ha, Ha, Ha, Aa, Aa, Aa, Ha, Aa, Aa, Aa, Aa, Aa, Ha, Aa, Ha, Aa, Ha, Ha, Ha, Ha, Ha, Ha, Ha, Aa, Aa, Aa, Ha, Ha, Aa
Wo, Wo, Wo, Aa, Ha, Ha, Ha, Ha, Ha, Aa, Aa, Aa, Aa, Aa, Ha, Aa, Aa, Aa, Aa, Ha, Aa, Ha, Aa, Aa, Aa, Aa, Aa, Aa, Ha, Aa, Aa, Aa, Aa, Ha, Aa, Aa, Aa, Ha, Ha, Aa, Aa, Aa, Ha, Aa
Wo, Ai, Ha, Wo, Ai, Aa, Cea^Vct, Cea, 1 Kea, Cea, Cea^Vct, Ha, Aa, Aa, Aa, Ha, Ha, Ha, Ha, Ha, Ha, Ha, Ha, Aa, Ha, Aa, Ha, Aa, Ha, Ha, Ha, Ha, Ha, Aa, Ha, Ha, Aa, Aa, Ha, Ha, Ha, Ha, Ha, Aa
Wo, Wo, Ai, Ai, Ai, Ai, Ai, Cea, Aa, Cea, Aa, Aa, Aa, Aa, Aa, Ha, Aa, Ha, Ha, Ha, Ha, Ha, Ha, Ha, Ha, Ha, Ha, Ha, Ha, Ha, Ha, Ha, Ha, Ha, Ha, Ha, Aa, Aa, Aa, Ha, Ha, Ha, Aa, Aa
Ha, Ha, Aa, Ai, Ai, Wo, Ai, Ha, Ha, Ha, Ha, Ha, Ha, Ha, Ha, Aa, Aa, Ha, Ha, Ha, Ha, Ha, Ha, Ha, Ha, Ha, Ha, Ha, Ha, Ha, Ha, Ha, Ha, Ha, Ha, Aa, Aa, Aa, Ha, Ha, Ha, Aa, Aa, Aa
Aa, Aa, Aa, Ha, Ha, Wo, Wo, Ai, Ai, Aa, Aa, Aa, Aa, Ha, Aa, Aa, Aa, Ha, Ha, Ha, Aa, Aa, Ha, Ha, Ha, Ha, Ha, Ha, Ha, Ha, Ha, Aa, Ha, Ha, Ha, Aa, Ha, Ha, Ha, Ha, Aa, Aa, Ha, Aa
Aa, Ha, Aa, Aa, Ha, Aa, Ai, Ai, Ai, Wo, Ai, Wo, Wo, Aa, Wo, Wo, Wo, Aa, Ha, Ha, Ha, Ha, Aa, Aa, Ha, Ha, Ha, Ha, Ha, Ha, Ha, Ha, Ha, Ha, Aa, Ha, Aa, Ha, Ha, Aa, Ha, Ha, Ha, Ha
Aa, Aa, Ha, Aa, Aa, Ha, Ha, Wo, Aa, Ai, Ai, Ai, Ai, Ai, Aa, Ai, Ai, Aa, Aa, Ha, Ha, Aa, Aa, Aa, Aa, Aa, Aa, Ha, Ha, Ha, Ha, Ha, Ha, Aa, Ha, Aa, Aa, Ha, Aa, Aa, Ha, Ha, Aa, Aa
Aa, Ha, Aa, Aa, Ha, Aa, Aa, Aa, Aa, Aa, Aa, Ai, Ai, Ai, Ai, Aa, Wo, Aa, Aa, Aa, Aa, Aa, Aa, Ha, Aa, Aa, Aa, Ha, Cea, Ha, Aa, Ha, Ha, Ha, Ha, Aa, Ha, Ha, Ha, Ha, Ha, Aa, Ha, Aa
Ha, Aa, Ha, Ha, Ha, Aa, Aa, Aa, Ha, Aa, Aa, Aa, Ai, Ai, Ai, Ai, Ai, Aa, Ai, Ai, Wo, Aa, Aa, Aa, Aa, Aa, Aa, Ha, Re^Vct, Aa, Ha, Aa, Ha, Ha, Ha, Ha, Ha, Ha, Ha, Aa, Ha, Ha, Aa, Ha
Aa, Aa, Ha, Ha, Ha, Aa, Ha, Aa, Ha, Aa, Aa, Aa, Aa, Ai, Ai, Ai, Ai, Ai, Wo, Ai, Ai, Aa, Aa, Ha, Aa, Aa, Cea, Aa, Cea, Cea, Cea, Ha, Ha, Ha, Ha, Ha, Ha, Ha, Ha, Aa, Ha, Ha, Ha, Ha
Aa, Ha, Ha, Ha, Ha, Ha, Ha, Aa, Aa, Aa, Ha, Aa, Aa, Aa, Aa, Aa, Aa, Ai, Ai, Aa, Ai, Aa, Aa, Aa, Aa, Aa, Aa, Aa, Cea, Cea, 3 Kea, Cea, Cea, Ha, Ha, Ha, Ha, Ha, Ha, Ha, Ha, Ha, Ha, Aa
Aa, Ha, Ha, Ha, Ha, Ha, Ha, Aa, Aa, Ha, Ha, Aa, Aa, Aa, Aa, Aa, Aa, Wo, Wo, Aa, Wo, Ai, Aa, Aa, Rb, Rb, Rb, Aa, Aa, Cea, Cea, Cea, Cea, Aa, Ha, Ha, Aa, Ha, Ha, Ha, Ha, Ha, Ha, Ha
Ha, Ha, Ha, Ha, Ha, Ha, Aa, Aa, Aa, Ha, Ha, Aa, Aa, Aa, Aa, Aa, Aa, Aa, Aa, Ai, Ai, Ai, Ha, Aa, Aa, Rb, Ha, Cea, Aa, Re^Vct, Aa, Cea, Aa, Re^Vct, Cea, Ha, Aa, Aa, Ha, Ha, Aa, Ha, Ha, Aa
Aa, Ha, Ha, Ha, Ha, Ha, Ha, Ha, Aa, Aa, Aa, Aa, Aa, Aa, Aa, Ha, Aa, Aa, Aa, Wo, Ai, Aa, Aa, Ha, Aa, Aa, Aa, Aa, Aa, Cea, Ha, Aa, Cea, Aa, Rb, Rb, Ha, Aa, Ha, Aa, Aa, Ha, Ha, Ha
Ha, Ha, Ha, Ha, Ha, Aa, Ha, Ha, Cea, Aa, Aa, Cea, Ha, Aa, Aa, Aa, Aa, Aa, Aa, Aa, Ai, Ai, Aa, Aa, Ha, Aa, Ha, Aa, Aa, Aa, Rb, Aa, Aa, Aa, Aa, Ha, Ha, Ha, Aa, Ha, Aa, Aa, Aa, Ha
Ha, Ha, Ha, Ha, Ha, Ha, Ha, Aa, Ha, Aa, Cea, Re^Vct, Aa, Aa, Aa, Aa, Aa, Aa, Aa, Aa, Wo, Ai, Wo, Ha, Aa, Ha, Aa, Aa, Aa, Rb, Rb, Ha, Aa, Aa, Ha, Ha, Ha, Ha, Ha, Aa, Ha, Ha, Ha, Aa
Ha, Ha, Ha, Ha, Ha, Ha, Ha, Ha, Ha, Cea, 2 Kea, Cea, Cea, Aa, Cea, Aa, Aa, Aa, Aa, Aa, Wo, Ai, Ai, Aa, Aa, Aa, Aa, Aa, Aa, Aa, Rb, Rb, Rb, Aa, Aa, Ha, Aa, Ha, Ha, Ha, Ha, Ha, Ha, Aa
Ha, Ha, Ha, Ha, Ha, Ha, Ha, Cea, Re^Vct, Cea, Cea, Cea, Cea, Aa, Aa, Aa, Aa, Aa, Aa, Aa, Aa, Wo, Ai, Aa, Aa, Aa, Aa, Aa, Aa, Aa, Aa, Rb, Rb, Ha, Aa, Ha, Ha, Aa, Aa, Aa, Ha, Ha, Aa, Aa
Ha, Ha, Ha, Ha, Ha, Ha, Ha, Ha, Aa, Cea, Cea, Cea, Re^Vct, Aa, Rb, Aa, Ha, Aa, Aa, Aa, Aa, Aa, Ai, Wo, Aa, Aa, Aa, Ha, Aa, Ha, Chr, Rb, Aa, Ha, Aa, Aa, Ha, Aa, Aa, Aa, Aa, Aa, Ha, Ha
Aa, Ha, Ha, Ha, Ha, Ha, Ha, Ha, Cea, Aa, Ha, Aa, Cea, Ha, Rb, Ha, Aa, Aa, Aa, Aa, Aa, Wo, Ai, Wo, Aa, Aa, Ha, Aa, Ha, Ha, Rb, Aa, Aa, Aa, Ha, Aa, Aa, Aa, Aa, Ha, Aa, Aa, Ha, Ha
Aa, Ha, Ha, Ha, Ha, Ha, Aa, Aa, Ha, Rb, Rb, Ha, Aa, Rb, Rb, Aa, Aa, Chr, Aa, Aa, Aa, Aa, Ai, Wo, Wo, Aa, Aa, Chr, Ha, Ha, Aa, Rb, Rb, Ha, Ha, Chr, Ha, Aa, Aa, Ha, Ha, Ha, Aa, Aa
Ha, Ha, Ha, Ha, Ha, Ha, Ha, Aa, Aa, Rb, Ha, Ha, Aa, Ha, Ha, Ha, Rb, Aa, Rb, Aa, Aa, Ai, Ai, Wo, Wo, Aa, Aa, Aa, Aa, Aa, Aa, Rb, Rb, Aa, Ha, Aa, Aa, Ha, Aa, Aa, Aa, Aa, Aa, Ha
Ha, Ha, Ha, Ha, Ha, Ha, Ha, Aa, Aa, Aa, Aa, Aa, Aa, Aa, Aa, Aa, Rb, Rb, Ha, Aa, Aa, Aa, Ai, Ai, Wo, Wo, Aa, Wo, Aa, Aa, Aa, Chr, Chr, Aa, Aa, Aa, Ha, Aa, Chr, Aa, Aa, Ha, Aa, Ha
Ha, Ha, Ha, Ha, Ha, Ha, Ha, Ha, Aa, Ha, Aa, Aa, Aa, Chr, Aa, Rb, Aa, Rb, Rb, Rb, Chr, Aa, Aa, Ai, Ai, Wo, Wo, Ai, Aa, Aa, Aa, Rb, Rb, Aa, Aa, Aa, Aa, Aa, Aa, Aa, Aa, Aa, Ha, Ha
Aa, Ha, Ha, Ha, Ha, Ha, Ha, Ha, Ha, Ha, Ha, Ha, Aa, Ha, Ha, Aa, Aa, Aa, Ha, Chr, Rb, Aa, Aa, Ai, Ai, Wo, Aa, Ai, Ai, Aa, Chr, Rb, Aa, Aa, Aa, Ha, Ha, Ha, Aa, Aa, Ha, Aa, Aa, Ha
Aa, Ha, Ha, Ha, Ha, Ha, Ha, Ha, Aa, Aa, Aa, Aa, Aa, Aa, Aa, Aa, Ha, Ha, Aa, Ha, Rb, Rb, Aa, Ai, Ai, Wo, Wo, Wo, Ai, Chr, Chr, Chr, Aa, Aa, Aa, Aa, Ha, Aa, Ha, Aa, Ha, Ha, Aa, Aa
Aa, Ha, Ha, Ha, Ha, Ha, Ha, Ha, Ha, Ha, Ha, Ha, Chr, Aa, Aa, Aa, Ha, Aa, Ha, Aa, Rb, Aa, Chr, Chr, Ai, Aa, Wo, Wo, Ai^Kov, Ai^Kov, Chr, Chr, Aa, Aa, Aa, Ha, Aa, Ha, Ha, Aa, Aa, Aa, Ha, Aa
Aa, Ha, Ha, Ha, Ha, Ha, Ha, Ha, Ha, Ha, Ha, Aa, Ha, Aa, Aa, Aa, Rb, Aa, Aa, Ha, Ha, Aa, Chr, Chr, Ai^Kov, Ai^Kov, Ai^Kov, 4 Wo^Cov, Ai, Ai^Kov, Aa, Aa, Aa, Aa, Rb, Chr, Aa, Aa, Aa, Aa, Ha, Ha, Aa, Ha
Ha, Aa, Ha, Ha, Ha, Ha, Ha, Ha, Ha, Ha, Ha, Ha, Aa, Ha, Aa, Rb, Chr, Chr, Aa, Aa, Ha, Ha, Ha, Ha^Kov, Ai^Kov, Ai^Kov, Ai, Wo, Wo, Aa, Aa, Aa, Aa, Rb, Rb, Chr, Aa, Ha, Aa, Aa, Aa, Aa, Aa, Ha
Ha, Ha, Ha, Ha, Aa, Ha, Ha, Ha, Ha, Ha, Ha, Ha, Aa, Aa, Aa, Ha, Aa, Rb, Aa, Aa, Aa, Ha, Aa, Aa, Ai, Ai, Ai, Ai, Wo, Ai, Ai, Aa, Ha, Ha, Ha, Aa, Aa, Ha, Aa, Aa, Aa, Aa, Ha, Ha
Ha, Ha, Ha, Ha, Ha, Ha, Ha, Ha, Aa, Ha, Ha, Ha, Ha, Ha, Ha, Aa, Aa, Ha, Aa, Ha, Aa, Aa, Aa, Aa, Aa, Aa, Aa, Ai, Ai, Wo, Ai, Aa, Ha, Aa, Aa, Ha, Ha, Aa, Aa, Aa, Aa, Aa, Ha, Aa
