border_size=1
usage=map

Ko, Ko, Co, Co, Co, Ko, Ko
Co, Co, Rd, 1 Rd, Rd, Co, Co
Co, Rd, Re, Re, Re, Rd, Co
Co, Rd, Re, Rd, Re, Re, Co
Co, Rd, Rd, Rd, Re, Rd, Co
Ko, Co, Co, Rd, Co, Co, Ko
Ko, Ko, Co, Rd, Co, Ko, Ko
