border_size=1
usage=map

Ww, Wo, Wo, Ww, Ww, Ww, Gg, Gg, Hh, Hh, Hh, Mm, Mm, Gg, Mm, Hh, Gg^Fp, Gg, Gg^Fp, Gg^Fp, Gg, Hh, Hh, Gg, Gll^Fp, Gll^Fp, Hh^Fp, Gll^Fp, Gll^Fp, Gg, Gg^Fms, Gg, Gg^Fms, Gg^Fms, Hh^Fms, Hh^Fms, Gg^Fms, Gg^Fms, Gg^Fms, Gg^Fms, Gg^Fms, Gg^Fms, Gg^Fms, Hh, Gg^Fp, Gg^Fms, Gg^Fms, Gg^Fms, Gg, Gg, Gg, Gg, Gg, Gg, Hh, Gg, Mm, Gg, Mm, Ww, Mm, Gg
Ww, Ww, Wo, Ww, Ww, Ww, Gg, Gg^Fp, Gg^Fp, Hh, Gg, Mm, Mm, Mm, Hh^Fp, Hh^Fp, Mm, Mm, Hh, Hh^Fp, Gg^Fms, Hh, Gg^Efm, Gg^Efm, Gg^Efm, Gll^Fp, Hh^Fp, Gs^Fms, Gs^Fms, Gg, Gg, Gg, Gg, Hh, Hh, Hh, Hh, Hh^Fms, Hh, Gg^Fms, Gg^Fms, Gg^Fp, Gg, Hh, Hh, Gg^Fp, Gg^Fp, Gg, Gg, Gg, Gg^Fet, Gg^Fms, Gg^Fms, Gg, Gg^Efm, Hh, Hh, Mm, Ww, Ww, Mm, Mm
Wo, Ww, Ww, Ww, Wo, Ww, Wo, Gg, Gg^Fp, Gg^Fp, Gg, Mm, Hh, Hh, Hh^Fp, Mm, Gg^Fp, Ww, Hh^Fp, Hh^Fp, Hh^Fms, Hh, Gg^Efm, Gg^Efm, Gg^Efm, Hh^Efm, Gg, Gll^Fp, Gg, Gg, Gg, Gg, Hh, Gg, Gg, Hh, Gg, Hh, Hh^Fp, Hh^Fp, Hh^Fp, Hh^Fp, Hh^Fp, Hh, Gg, Gg, Gg, Gs^Fp, Gs, Gg, Gg, Gs^Fms, Gg, Gg^Efm, Gg^Efm, Gg^Efm, Ww, Ww, Mm, Hh^Fms, Hh^Fms, Mm
Wo, Ww, Ww, Ww, Ww, Ww, Ww, Wo, Ww, Ds, Ds, Gg, Gg, Gg^Fp, Hh^Fp, Hh, Hh^Fp, Hh^Fp, Hh, Gg, Gg^Fms, Gg, Gg, Gg^Efm, Gg^Efm, Gg^Efm, Gg, Gg, Gg, Gg, Gg, Hh, Hh, Mm, Mm, Gg, Gg, Gg, Gg, Gll^Fp, Gs^Fms, Hh^Fp, Gs^Fms, Gg, Gg, Gs, Gg, Gg, Gg, Gll^Fp, Gll^Fp, Gll^Fp, Gg, Gg^Efm, Ww, Ww, Gg^Efm, Gg^Efm, Gg^Efm, Mm, Hh^Fms, Hh
Ds, Wo, Wo, Wo, Ww, Wo, Ww, Ww, Ww, Wo, Wo, Wo, Wo, Co, Co, Gg, Gs, Gs^Ecf, Gs, Gs^Vo, Gg^Fms, Gg, Hh^Fms, Hh, Gg, Gg, Gll^Fp, Gg, Gll^Fp, Gg, Gg, Gg, Mm, Mm, Mm, Gg, Gg, Gg, Gg, Gg, Gll^Fp, Gs^Fms, Gs^Fms, Gll^Fp, Gll^Fp, Gg, Gg, Gg, Gg, Gll^Fp, Gll^Fp, Gg, Gg, Ww, Ww, Ww, Gg^Efm, Gg^Efm, Gg^Efm, Gg^Efm, Gg, Hh
Ds, Wo, Wo, Ww, Ww, Ww, Ww, Ww, Ww, Ww, Ww, Ww, Wwf, Wo, Wwf, Gg, Gs, Gg, Gs, Gg, Gg, Hh^Fms, Gg^Fms, Gg, Gg^Fet, Gll^Fp, Hh^Fms, Gll^Fp, Gg, Gg, Gg, Gg, Gg, Mm, Mm, Hh, Hh, Gg, Gg^Vo, Gs, Gs, Gg, Gg, Gg, Gg, Gg, Gg, Gg, Gs, Gg, Gs^Fms, Gg, Ww, Ww, Ww, Ww, Gg^Efm, Gg^Efm, Gg^Efm, Gg^Efm, Gg, Gg
Gg^Fp, Ds, Ds, Wo, Wo, Ww, Ww, Wo, Ww, Ww, Wwf, Ww, Wwf, Wwf, Wwf, Wwf, Ww, Co, Co, Gs, Gs, Hh, Gg, Gg^Fms, Hh^Fp, Gll^Fp, Gs^Fms, Gs^Fms, Gll^Fp, Gg, Gll^Fp, Gg, Mm, Mm, Gg, Hh, Gg, Gg, Gg, Gg, Gg, Gg, Gg, Gg, Gg, Gs, Gg, Gg, Gg, Gg, Hh^Fms, Gs^Fms, Gs^Fms, Ww, Ww, Ww, Gg^Vo, Gg, Gg, Gg, Gg, Gg
Gg^Fms, Gg^Fp, Gg^Fp, Gg, Gg^Efm, Ww, Co, Ww, Ww, Wwf, Wwf, Wwf, Wwf, Wwf, Ww, Wo, Wo, Ww, Sm, Ss, Ss, Gg, Gg, Gg, Gll^Fp, Hh^Fms, Gll^Fp, Gg, Gg, Gll^Fp, Gll^Fp, Gll^Fp, Gg, Gg, Gg, Gg, Gg, Gg, Gg, Gg, Hh, Gg, Gg, Gg, Gs^Fms, Gg, Gg, Gs^Fms, Gll^Fp, Hh, Hh, Hh^Fms, Gg, Gs^Fms, Gg, Gg, Gg, Gg, Gg^Fms, Gg, Gg, Gg
Gg^Fms, Gg^Fet, Gg^Fp, Gg, Gg, Gg^Efm, Gg^Efm, Co, Gg, Wwf, Wwf, Wwf, Wwf, Ww, Ww, Wo, Wo, Wo, Wo, Sm, Ss, Gg, Gg, Gg, Gg, Gg, Gg, Gg, Gg, Gg, Gg, Gg, Gg, Gg, Gg, Gg, Gg, Gg, Hh, Hh^Fms, Gg, Hh, Hh^Fp, Gll^Fp, Gg, Gg, Gg, Gg, Gll^Fp, Hh^Fp, Gs^Fms, Hh, Hh, Hh, Gg, Gg, Hh^Fms, Gg, Gg, Gg^Fms, Hh, Gg
Gg^Fms, Gg, Gg^Fp, Gg^Fp, Ww, Gg, Gg, Gg, Gg, Gg, Co, Wo, Wo, Wo, Ww, Wo, Ww, Wo, Wo, Sm, Ss, Ss, Gg, Gg, Gg, Gg, Gg, Gg, Gg, Gg, Gg^Efm, Gg^Efm, Gg^Efm, Gg, Gg, Gg^Fp, Gg^Fp, Hh, Hh, Hh, Gll^Fp, Hh^Fms, Gll^Fp, Gg^Fet, Gg, Gs^Fms, Gg, Gg, Gg, Gg, Gg, Gg, Gg, Gg, Gg, Gg, Hh^Fms, Gg^Fms, Gg, Gg, Hh^Fp, Gg
Gg^Fms, Gg^Fms, Hh, Hh, Hh^Fp, Ww, Hh^Fms, Gg^Vo, Gg^Ecf, Gg, Gg, Co, Gg, Wo, Wo, Wo, Ww, Ww, Ww, Sm, Sm, Ss, Ss, Gg, Gg, Gg^Vo, Gg, Gg, Gg, Gg, Gg^Efm, Gg^Efm, Gg^Efm, Gg, Gg, Gg, Gg^Fp, Gg^Fp, Gg^Fp, Gs^Fms, Co, Co, Co, Gs^Fms, Gs^Fms, Gg, Gg, Gg^Vo, Gg, Gg, Gg, Gg, Gs, Gg, Gg, Gg, Gg, Gg^Fms, Gs^Fms, Hh, Hh, Gg
Gg^Fms, Hh, Ww, Hh, Hh, Ww, Hh, Hh^Fms, Hh, Gg, Gg, Gg, Gg, Gg, Wo, Wo, Wo, Wo, Ww, Ww, Ww, Sm, Sm, Gg, Gg, Gg, Gg, Gg, Gg, Gg^Efm, Gg^Efm, Gg^Efm, Gg, Gg, Gg, Gg, Gg^Fms, Hh^Fp, Co, Co, Co, Co, Co, Co, Co, Gg, Gg, Gg, Gs, Gs, Hh^Fp, Gg, Hh^Fms, Gs, Gs, Gg, Gg^Fet, Gg^Fms, Gll^Fp, Gg, Gg, Hh
Hh^Fms, Gg^Fms, Ww, Mm, Mm, Mm, Mm, Hh^Fms, Ww, Gg, Gs^Fms, Gg^Fms, Gg^Fms, Gg, Gg, Wo, Wo, Ww, Ww, Ww, Wo, Sm, Ss, Gg, Gg, Gg, Gg, Gg, Gg, Gg^Efm, Gg^Efm, Gg^Efm, Gg, Gg^Fms, Gg^Fms, Gg^Fms, Gg, Co, Co, Co, Co, 2 Ko, Co, Co, Co, Co, Gg^Fms, Gs, Gg, Hh^Fp, Gs^Fp, Hh^Fms, Gs, Gs, Gg, Gg^Fp, Gs^Fms, Gs^Fms, Gg^Fms, Gll^Fp, Gll^Fp, Gg
Gg^Fms, Hh^Fms, Hh, Mm, Mm, Mm, Mm, Hh, Hh, Gg, Gg, Gg^Fms, Gg^Fms, Gg^Fms, Gg, Gg, Wo, Wo, Ww, Wo, Wo, Ss, Ss, Gg, Gg, Gs^Fms, Gs^Fms, Gll^Fp, Gll^Fp, Gg, Gg^Vo, Gg, Gg, Gg, Gg^Fms, Gg, Gg, Gg, Gg, Co, Co, Co, Co, Co, Gg, Gs, Gg, Gs, Gg, Gg^Fms, Gs^Fp, Gs^Fp, Gs, Hh, Gg^Fp, Gs^Fp, Hh^Fms, Gll^Fp, Hh, Hh, Hh, Gg
Gg, Ww, Hh, Hh, Mm, Mm, Mm, Ww, Gs, Hh, Gs, Gg, Gg, Gg, Gg, Gg, Wo, Wo, Wo, Ww, Wo, Ss, Gg^Efm, Gg, Gg, Gg, Gs^Fms, Gs^Fms, Gs^Fms, Gg, Gg, Gg, Gg, Gg^Fet, Gg, Gg, Gg, Gg, Gg, Gg, Rb, Co, Rb, Gg, Rb, Gs^Fms, Gs, Gs, Rb, Gg^Fp, Rb, Gs, Gg, Gg^Fp, Gg, Gs, Gs^Fms, Gs^Fms, Gg, Gg, Gg, Gg
Gg^Fp, Gg^Fms, Ww, Ww, Mm, Mm, Hh^Fp, Mm, Mm, Gg, Gg, Gs, Gs, Gg, Gg, Gs, Ww, Wo, Wo, Ww, Wo, Gg^Efm, Gg^Efm, Gg, Gg, Gg, Gll^Fp, Gs^Fms, Gll^Fp, Gg, Gg, Gg, Gg^Fp, Gg^Fp, Gg, Gg^Fms, Gg^Efm, Gg^Efm, Rb, Rb, Rb, Rb, Rb, Rb, Rb, Rb, Rb, Rb, Rb, Rb, Rb, Rb, Rb, Rb, Rb, Rb, Rb, Gs^Fms, Rb, Rb, Rb, Rb
Gg^Fp, Gg^Fms, Ww, Hh, Hh^Fms, Hh^Fp, Hh, Hh, Mm, Gg, Gs, Gg, Gg, Gg, Ds, Ww, Ww, Ww, Ww, Ww, Wo, Gg^Efm, Gg^Efm, Gg, Gg, Gg, Gg, Gs, Gs, Gg, Gg, Gg, Gg^Fp, Gg^Fp, Gg, Gg^Efm, Rb, Rb, Rb, Rb, Rb, Rb, Rb, Rb, Rb, Rb, Rb, Rb, Rb, Rb, Rb, Rb, Rb, Rb, Rb, Rb, Rb, Rb, Rb, Rb, Rb, Rb
Gg^Fp, Gg^Fms, Gg^Fet, Gg^Fms, Gg^Fms, Gg^Fms, Gg^Fms, Gg, Gg, Gg, Gg, Gg, Gg, Gg, Ds, Wo, Ww, Wo, Ww, Ww, Ww, Gg^Efm, Gg^Efm, Gg, Gg, Gg^Fp, Gg, Gg, Gs, Gs, Gg, Gg, Gg, Gg^Fp, Rb, Rb, Rb, Rb, Rb, Rb, Gg, Gg, Gg, Gg, Gll^Fp, Rb, Gs^Fms, Gll^Fp, Gll^Fp, Gg, Gg, Rb, Gg^Efm, Rb, Gg^Efm, Rb, Gg^Efm, Rb, Rb, Rb, Gg, Gg
Gg, Gg^Fp, Gg^Fp, Gg^Fms, Gg, Gg^Fms, Gg, Gg, Gg, Gg, Gg, Gg^Vo, Gg, Ds, Wo, Wo, Ww, Wo, Ww, Ww, Wo, Gg^Efm, Gg, Gg, Gg, Gg^Fp, Gg^Fp, Gg, Gg, Gg, Gg, Gg, Rb, Rb, Rb, Rb, Rb, Rb, Gg^Efm, Gg^Efm, Gg, Gg, Gg, Gg, Gg, Gll^Fp, Hh^Fms, Hh, Gg, Gg, Gg, Gg^Efm, Gg^Efm, Gg^Efm, Gg^Efm, Gg^Efm, Hh, Hh, Hh^Fp, Hh, Hh, Gg
Gg^Fp, Gg^Fp, Gg^Fp, Gg^Fp, Gg, Gg, Gg^Efm, Gg^Efm, Gg^Efm, Gg, Gg, Gg, Wo, Wo, Wo, Ww, Ww, Ww, Ww, Wo, Ds, Ds, Gg, Gg, Gg, Gg, Gll^Fp, Gg, Gg, Gg^Vo, Gs, Rb, Rb, Rb, Rb, Rb, Gg, Gg, Gg, Gg, Gg, Gg, Gg, Gll^Fp, Gg^Fet, Gs^Fms, Hh, Hh, Gg, Gg, Gg, Gg, Hh^Fms, Gg^Vo, Gg^Efm, Mm, Hh^Fp, Hh^Fp, Hh, Hh^Fp, Mm, Gg
Gg, Gg^Fp, Gg^Fp, Gg, Gg, Gg^Efm, Gg^Efm, Gg^Efm, Gg^Efm, Gg, Gg, Wo, Wo, Wo, Ww, Ww, Wo, Wo, Wo, Ww, Ds, Ds, Gg, Gg, Gs^Fms, Gll^Fp, Gll^Fp, Gll^Fp, Gg, Gg, Rb, Rb, Rb, Gs, Gg^Fms, Gg^Fms, Gg, Gg, Gg^Fms, Gg, Gg, Gg, Gg, Gll^Fp, Gll^Fp, Hh^Fp, Gll^Fp, Gll^Fp, Gg, Gg, Gg, Hh, Hh^Fms, Hh, Mm, Mm, Hh^Fp, Hh, Mm, Hh, Mm, Mm
Gg, Gg, Gg^Fp, Gg, Gg, Gg^Efm, Gg^Ecf, Gg^Efm, Co, Co, Wo, Wo, Ww, Ww, Wo, Wo, Wo, Wo, Ds, Ds, Ds, Ds, Gll^Fp, Gs^Fms, Gs^Fms, Gll^Fp, Gll^Fp, Gll^Fp, Gg, Gg, Rb, Rb, Rb, Gg^Fet, Gs^Fms, Gg^Fms, Gs^Fms, Gg, Gg^Fms, Gg, Gg, Gg, Gg, Gg, Gs, Gg, Gg, Gg, Gg, Gg, Gg, Gg, Mm, Hh, Hh^Fp, Hh^Fp, Hh, Mm, Hh^Fp, Hh^Fp, Mm, Mm
Gg^Fp, Gg^Fp, Gg, Gg, Gg^Vo, Gg^Efm, Gg^Efm, Gg^Efm, Wwf, Wo, Wwf, Ww, Ww, Ww, Wo, Ww, Co, Gs, Gg, Gg, Gg, Gg, Gll^Fp, Gs^Fms, Gll^Fp, Gs^Fms, Gs^Fms, Gs^Fms, Gg, Rb, Rb, Rb, Gs, Gg, Gs, Gg, Gg, Gg, Gg, Gs, Gg, Gg, Gg, Gg, Gg, Gs, Gg, Gg, Gg, Gg, Gg, Gg, Mm, Hh^Fp, Hh^Fp, Ww, Hh, Mm, Mm, Mm, Hh^Fp, Hh
Gg^Efm, Gg^Efm, Gg, Gg, Gg, Gg, Gg^Efm, Ww, Wwf, Wwf, Wwf, Wwf, Wwf, Wwf, Wo, Co, Gs, Gs, Gg, Gg^Vo, Gg, Gg, Gg, Gll^Fp, Gll^Fp, Gs^Fms, Gg, Gg, Gg, Rb, Rb, Rb, Gg, Gg, Gg, Gg, Gg, Gg, Gg, Gg, Gs^Vo, Gs, Gs, Gg, Gg, Gg, Gs, Gg, Gg, Gg^Vo, Gg, Hh, Gg, Hh, Gg, Hh, Ww, Mm, Mm, Mm, Mm, Hh
Gg^Efm, Gg^Efm, Gg, Gg, Gg^Efm, Gg^Ecf, Gg^Efm, Co, Sm, Wwf, Wwf, Wwf, Wwf, Wwf, Gg, Gg, Gg, Gg^Ecf, Gg, Gg, Gg, Gg, Gg, Gg, Gg, Gg, Gg, Gg, Gg, Rb, Rb, Rb, Gg, Gg, Gll^Fp, Gll^Fp, Gg, Gg, Gg, Gg, Gg, Gs, Gs, Gg, Gg, Gs, Gg, Gg, Gg, Gg, Gg, Gg, Gg, Hh, Hh^Fp, Mm, Hh, Ww, Mm, Mm, Mm, Hh
Gg^Fp, Gg^Efm, Hh^Efm, Hh^Fp, Hh^Efm, Gg^Efm, Gg^Efm, Co, Sm, Ww, Ww, Ww, Ww, Gg, Co, Gg, Gg^Ecf, Gg, Gg^Fet, Gg^Fp, Gg^Fp, Gg, Gg, Gg, Gg^Efm, Gg^Efm, Gg^Efm, Gg^Efm, Rb, Rb, Rb, Rb, Gg, Gg, Gll^Fp, Gs^Fms, Gs^Fms, Gg, Gg, Gg, Gg, Gg, Gg, Gg, Gg, Gg, Hh^Fms, Hh^Fms, Hh^Fms, Gll^Fp, Gs^Fms, Gg, Gg, Gg, Gg, Hh^Fms, Gg^Fms, Hh^Fp, Hh, Mm, Mm, Mm
Hh^Efm, Hh^Efm, Gg^Fp, Gg^Fp, Gg^Fp, Gg^Efm, Ss, Gg, Sm, Sm, Wo, Wo, Ww, Wo, Co, Gs, Gg, Gg, Gg, Gg^Fp, Gg^Fp, Gg, Gg, Gg, Gg^Efm, Gg^Efm, Gg^Efm, Gg^Efm, Rb, Rb, Rb, Gg, Gg, Gg, Gll^Fp, Gs^Fms, Gs^Fms, Gg, Gg, Gg, Gg, Gg, Gg, Gg, Gg, Gg, Gg, Gs^Fms, Gs^Fms, Gg, Gs^Fms, Gs^Fms, Gg, Gg, Gg, Gg^Fms, Hh^Fms, Gg, Hh^Fp, Ww, Hh, Gg
Hh, Gg, Gg^Fet, Gg^Fp, Gg, Gg, Ss, Ss, Sm, Sm, Ww, Wo, Ww, Wo, Wo, Gg, Gg^Vo, Gs, Gg^Fp, Gg, Gg^Fp, Gg, Gg, Gg, Gg, Gg^Efm, Rb, Rb, Rb, Rb, Gg, Gg, Gg, Gg, Gg, Gll^Fp, Gg, Gg, Gg, Gg, Gg^Vo, Gg, Gg, Gg, Gg, Gg^Ecf, Gg, Gg, Co, Gg, Gg, Gg, Gg, Gg^Ecf, Gg, Gg, Gg, Hh^Fms, Gg, Hh, Gg, Gg
Gg, Hh, Gg^Fp, Gg, Gg, Gg, Ss, Ss, Sm, Sm, Sm, Ww, Wo, Ww, Ww, Gg, Gs, Gg, Gg, Gg^Fp, Gg, Gg^Fp, Gg, Gg^Vo, Rb, Rb, Rb, Rb, Rb, Gg^Efm, Gg^Efm, Gg, Gg^Vo, Gg, Gg, Gg, Gg, Gg, Gg, Gg, Gg^Efm, Gg^Efm, Gg^Efm, Gg^Efm, Gg^Efm, Gg, Ds, Co, Wwf, Wwf, Wwf, Co, Co, Ss, Ss, Ss, Ss, Gg^Vo, Gg, Gg, Gg, Gg
Gg, Hh^Fp, Gg^Fp, Gg^Fp, Gg, Gg, Gg, Ss, Ss, Sm, Sm, Wo, Ww, Wo, Ww, Ww, Wo, Ds, Ds, Gg, Co, Gg, Gg, Gg^Ecf, Rb, Rb, Rb, Rb, Gg^Efm, Gg^Efm, Gg^Efm, Gg, Gg^Fms, Gg, Gg, Gg, Gg, Gg, Gg, Gg, Gg^Efm, Gg^Efm, Gg^Efm, Ww, Ww, Ds, Wo, Wo, Wwf, Wwf, Wwf, Wwf, Sm, Sm, Ss, Ss, Ss, Ss, Hh^Fp, Gg, Gg^Fet, Gg
Gg^Fp, Gg, Gg, Hh^Fp, Hh^Fp, Gg^Fp, Gg, Ss, Ss, Sm, Ww, Wo, Wo, Ww, Ww, Ww, Wo, Ds, Ds, Gg, Co, Co, Rb, Rb, Rb, Rb, Gg^Ecf, Gg^Efm, Gg^Efm, Rb, Gg, Gg^Fms, Gg^Fms, Gg^Fms, Gg, Gg, Gg, Gg, Gg, Gg, Ds, Ds, Ds, Ww, Ww, Wo, Ww, Ww, Wwf, Wwf, Wwf, Wwf, Wwf, Sm, Sm, Ss, Ss, Ss, Hh^Fms, Gs^Fms, Gg, Gg
Gg^Fp, Gg^Fp, Gg, Gs, Hh, Gg, Gs, Gs, Gs, Ss, Ds, Ww, Wo, Wo, Ww, Ww, Ww, Ww, Ww, Gg, Rb^Bsb/, Rb, Rb, Rb, Rb, Rb, Gg, Gg^Efm, Gg^Efm, Gg^Efm, Gg, Gg^Fms, Gg^Fms, Gg^Fet, Gg, Gg, Ds, Gg, Ww, Wo, Ww, Ds, Wo, Ww, Wo, Wo, Ww, Wo, Wwf, Wwf, Wwf, Wo, Wo, Ww, Wo, Sm, Sm, Ss, Ss, Gs^Fms, Hh^Fp, Gs
Gs^Fp, Gg^Fp, Gg^Fp, Hh, Hh, Gg, Gs, Gg, Gs, Gg, Gg, Ww, Ww, Ww, Wo, Ww, Ww, Ww, Ww^Bsb/, Ww^Bsb/, Ww^Bsb/, Rb^Bsb/, Rb^Bsb/, Rb, Co, Co, Wo, Gg, Ds, Gg, Ds, Ds, Ds, Gg, Ds, Ds, Ww, Ww, Wo, Ww, Ww, Ww, Wo, Wo, Wo, Wo, Wo, Wo, Wwf, Wwf, Wwf, Wo, Wo, Wo, Wo, Wo, Sm, Ss, Ss, Hh^Fms, Hh^Fp, Gg
Gs^Fp, Gs, Hh^Fp, Hh, Gs, Gg, Gs, Gg^Vo, Gs, Gs, Gs, Gs, Co, Ww, Wo, Ww, Ww^Bsb/, Ww^Bsb/, Ww^Bsb/, Wo^Bsb/, Wo^Bsb/, Ww^Bsb/, Wo, Ww, Ww, Co, Ww, Wo, Ww, Ds, Wo, Ds, Wo, Wo, Ww, Ww, Wo, Wo, Ww, Ww, Wo, Wo, Wo, Wo, Wo, Wo, Wo, Wwf, Wwf, Wwf, Wwf, Wwf, Wo, Wo, Ww, Ww, Ww, Sm, Ss, Gs^Fms, Gs^Fms, Gg
Gg^Fp, Gg^Fp, Gs, Gs, Gs^Fms, Gs, Gs, Gs, Gg, Gg, Gs, Gg, Co, Co, Rb, Ww^Bsb/, Ww^Bsb/, Ww^Bsb/, Ww^Bsb/, Wo^Bsb/, Wo, Wo, Wo, Wo, Wo, Wo, Wo, Ww, Wo, Wo, Wo, Wo, Ww, Wo, Wo, Wo, Ww, Ww, Ww, Wo, Ww, Ww, Ww, Wo, Wo, Wo, Co, Co, Gg, Gg, Co, Wo, Wo, Ww, Ww, Ww, Wo, Wo, Wo, Gg, Gll^Fp, Gg
Gg, Gg, Gg, Gs, Gs, Gg^Fp, Gs, Hh, Hh, Gs, Gs, Gg, Rb, Rb, Rb, Rb, Rb, Ww^Bsb/, Wo, Ww, Ww, Wo, Wo, Wo, Wo, Wo, Wo, Wo, Ww, Wo, Ww, Ww, Wo, Ww, Ww, Ww, Ww, Ww, Wo, Wo, Wo, Ww, Wo, Ww, Ww, Co, Gg, Gg, Gg^Ecf, Gg, Gg, Co, Co, Wo, Wo, Wo, Ww, Ww, Wo, Gg, Gg, Gg
Gg, Gg, Gg, Gg, Gg, Gg^Fms, Gg^Fms, Gg, Gs, Hh^Fp, Gs, Gg^Ecf, Rb, Rb, Rb, Rb, Co, Co, Co, Ww, Wo, Ww, Ww, Wo, Wo, Wo, Ww, Wo, Ww, Ww, Ww, Ww, Ww, Wo, Ww, Ww, Wo, Wo, Gg, Gg, Gs, Gg, Gg, Gg, Gg, Gg, Gg^Vo, Gg, Gg, Hh^Fp, Hh, Gg, Gg, Ww, Ww, Wo, Wo, Ww, Ww, Ds, Ds, Gg
Gs^Fp, Gs, Gg^Fp, Gg, Gg, Gg^Fp, Gg^Fms, Gg^Fet, Hh, Hh^Fp, Gg, Rb, Rb, Rb, Gg^Ecf, Gg, Gg, Gg^Efm, Gg^Efm, Gg^Efm, Gg^Efm, Gg, Gg^Efm, Ww, Wwf, Ww, Ww, Ww, Ww, Ww, Wo, Ww, Ww, Ww, Ds, Ds, Gg, Gg, Gg, Gg, Gg, Gg, Gg, Gg, Gg, Gg, Gg, Gg, Hh, Hh^Fp, Gg^Fp, Gg^Vo, Gg, Ds, Wo, Ww, Ww, Ww, Wo, Ww, Ds, Gg
Gg^Fp, Gs^Fp, Gg, Gg, Gg, Gg^Fp, Gs, Gs^Fp, Gg^Fp, Gg, Gg, Rb, Rb, Rb, Gg, Gg, Gg, Gg^Efm, Gg^Efm, Gg^Efm, Gg^Efm, Gg^Efm, Gg^Efm, Wwf, Wwf, Wwf, Gg, Ww, Gg, Ww, Gg, Gs, Gg, Gg, Gg, Gg, Gg, Gg, Gg^Vo, Gg, Gg, Gg, Gg, Gg, Gg, Gg, Gs^Fms, Gg, Gg, Gg, Gg^Fp, Gg, Gg, Wo, Wo, Wo, Wo, Ww, Wo, Ww, Ds, Gg
Gg, Gg^Fp, Gg, Gg, Gg, Gg, Gg, Gg^Fp, Gs, Gg^Fp, Gg, Rb, Rb, Rb, Gg, Gg, Hh, Gg, Gg, Gg^Efm, Gg^Vo, Gg^Efm, Gg^Efm, Wwf, Wwf, Wwf, Gg, Gg^Vo, Gg, Gg, Hh, Gg, Gg, Gg, Gg, Gg, Gg, Gg, Gg, Gg, Gg, Gg, Gll^Fp, Gll^Fp, Gs^Fms, Gll^Fp, Gg, Gg, Gg, Gs, Ss, Gg, Ss, Wo, Wo, Wo, Wo, Ww, Wo, Ds, Gg, Gg
Gg, Gg^Fp, Gg^Efm, Gg^Efm, Gg^Efm, Gg, Gg, Gg, Gg^Fp, Gg, Gg, Rb, Rb, Rb, Hh, Hh^Fms, Hh, Gg^Fp, Gg^Fp, Gg, Gg, Gg^Efm, Wwf, Wwf, Co, Wwf, Wwf, Gg, Gg, Hh, Gg^Fp, Gg^Fms, Gg, Gg, Gg, Gs, Gs, Gs, Gg, Gg, Gs, Gg, Gg^Fet, Gs^Fms, Hh, Gll^Fp, Gg, Gg, Gg, Gg, Ss, Ss, Wo, Wo, Ww, Wo, Ww, Ww, Ds, Ds, Gg, Gg
Gg, Gg, Gg^Efm, Gg^Efm, Gg^Efm, Gg^Efm, Gg, Gg, Gg, Gg, Gg, Rb, Rb, Rb, Gg, Hh^Fms, Hh^Fp, Gg^Fp, Gg, Gg, Gg, Gg, Co, Co, Co, Co, Co, Gg, Gg^Fms, Gg^Fms, Gg, Hh^Fp, Gg^Fp, Gg, Gg^Fms, Gg, Gg, Gg, Gs, Gg, Gs^Fms, Gll^Fp, Gs^Fms, Hh^Fp, Gg, Gg, Gg, Gg, Gg, Ss, Ww, Wo, Ww, Ww, Wo, Wo, Ww, Ss, Gg^Efm, Gg, Gg, Gg
Gg, Gg, Gg^Efm, Gg^Efm, Gg^Efm, Gg^Efm, Gg, Gg, Gg^Vo, Gg, Gg, Rb, Rb, Rb, Gs, Gg, Gg, Gg^Fms, Gg^Fms, Gg, Co, Co, Co, Co, 1 Ko, Co, Co, Co, Co, Gg^Fms, Gg^Fms, Hh, Gs^Fms, Gg^Fms, Gg^Fms, Gg, Gg, Gg, Gs, Gs, Gg, Gs^Fms, Hh, Gs^Fms, Gs^Fms, Gg, Gg, Gg, Wo, Ww, Ww, Ww, Ww, Wo, Wo, Wo, Wo, Ss, Gg^Efm, Gg, Gg, Gg
Gg, Gg, Gg, Gg^Fp, Gg, Gg, Gg, Gg, Gg, Gg, Gg, Rb, Rb, Rb, Gg, Gg, Gg^Fp, Gg, Hh^Fp, Gg^Fms, Gg, Co, Co, Co, Co, Co, Co, Co, Gg^Efm, Gg^Efm, Gg^Fms, Gg^Fms, Gg^Fms, Gg, Gg, Gg, Gs, Gs, Gg, Gg, Gg, Gg, Gg, Hh, Gg, Gg, Gg, Wo, Wo, Wo, Ww, Ww, Wo, Wo, Ww, Wo, Gg^Efm, Ss, Gs, Gg, Gg, Gg
Gg, Gg, Gg, Hh^Fp, Hh^Fp, Gg, Gg, Gg, Gg, Gg, Gg, Rb, Rb, Rb, Hh^Fms, Hh^Fms, Hh^Fp, Hh^Fp, Gg^Fp, Gg^Fms, Gg, Gg^Fms, Hh^Fms, Co, Co, Co, Gg, Gg^Efm, Gg^Efm, Gg^Efm, Gg, Gg^Fms, Gg, Gg, Gg, Gg, Gs, Gg, Gg, Gg, Gg, Gg, Gg^Vo, Gg, Gg, Gg, Ss, Wo, Ww, Ww, Ww, Wo, Ww, Ww, Ds, Gg^Efm, Gg^Efm, Gs, Gg, Gg, Gg, Gg
Gg, Gg, Hh, Gg, Gg, Hh^Fp, Hh^Fms, Gg^Fms, Gs^Fms, Gs, Gs^Fms, Rb, Rb, Rb, Gg^Fms, Gg, Gg, Hh, Gg, Gg^Fp, Gg, Gg, Gs^Fms, Hh, Gs^Fms, Gs^Fms, Gll^Fp, Gg, Gg, Gg, Gg, Gg, Gg, Gg, Gg, Gg, Gg, Gg, Gg^Efm, Gg^Efm, Gg^Efm, Gg, Gg, Gg, Gg, Ss, Ss, Ss, Ww, Ww, Ww, Wo, Ww, Wo, Ds, Gg, Gg, Gs, Gg, Gg^Fp, Gg, Gg
Gg, Hh, Hh, Gg^Fp, Gs, Gg, Gg, Gs, Gg^Fp, Gg^Fms, Gg, Rb, Rb, Rb, Rb, Gg, Gg, Gg^Vo, Gg, Gg, Gg, Gll^Fp, Gll^Fp, Hh^Fp, Gll^Fp, Gll^Fp, Gs^Fms, Gll^Fp, Gll^Fp, Gg, Gg, Gg, Gg, Gg, Gg, Gg, Gg^Efm, Gg^Efm, Gg^Efm, Gg^Efm, Gg^Efm, Gg, Gg, Gg, Gg, Ss, Sm, Wo, Wo, Ww, Wo, Wo, Ww, Ds, Gg, Gg, Gg^Vo, Gg, Hh, Gg^Fp, Gg^Fp, Gg^Fms
Mm, Gg, Hh, Hh^Fp, Hh^Fp, Gs, Gs, Gg, Gs, Gg^Fp, Gg^Fms, Gg, Gg, Rb, Rb, Rb, Rb, Gg, Gg, Gs^Fms, Gs, Gs, Gs, Gg, Gs^Fms, Gll^Fp, Hh^Fp, Gg, Gll^Fp, Gg, Gg, Gg, Gg^Vo, Gg, Gg, Gg, Gg^Efm, Gg^Efm, Gg^Efm, Gg^Efm, Gg^Efm, Gg, Gg, Gg, Gg, Sm, Sm, Wo, Ww, Wo, Ww, Ww, Wo, Gg, Gg, Gg, Gg, Gs, Gg^Fp, Gg^Fp, Gg^Fms, Gg
Mm, Mm, Hh^Fp, Hh, Gg, Gg^Fp, Hh^Fp, Gs, Gg, Gg^Fet, Hh^Fp, Hh^Fms, Hh^Fp, Rb, Rb, Rb, Rb, Rb, Gs, Gs^Fms, Gs^Fms, Gg, Gs^Fms, Gll^Fp, Gs^Fms, Gg, Gg, Gll^Fp, Gg, Gg, Gg, Gg, Gs, Gs, Gg, Gg, Gg, Gg^Efm, Gg^Efm, Gg^Efm, Gg^Efm, Gg, Gg, Gg, Gg, Gg, Ww, Wo, Wo, Ww, Ww, Ww, Ds, Gg, Gg, Gg, Gg, Hh, Gs^Fp, Gg^Fet, Gg^Fms, Gg
Gs, Gs, Hh^Fp, Hh, Mm, Hh, Gg, Gg, Hh, Gg^Fp, Gg, Hh, Gg, Gg^Fp, Gg, Rb, Rb, Rb, Gll^Fp, Gg^Fet, Gg, Gs^Fms, Gll^Fp, Gll^Fp, Gll^Fp, Gll^Fp, Gs^Fms, Gg, Gll^Fp, Gll^Fp, Gs, Gs, Hh^Fp, Hh, Hh, Gg, Hh, Gg, Hh, Gg^Efm, Gg, Gg, Gg, Gg, Gg, Gg, Ww, Ww, Wo, Wo, Wo, Ww, Gg, Gg, Gg, Gg, Gs, Hh, Gs, Gg^Fp, Gg^Fms, Gg
Gs, Hh, Hh, Gg, Mm, Mm, Mm, Mm, Mm, Hh, Gg, Gg, Gg, Gg, Hh^Fp, Rb, Rb, Rb, Gll^Fp, Gs, Gg, Gll^Fp, Gs^Fms, Hh^Fp, Hh^Fms, Gs^Fms, Gs, Gg, Gs, Gg, Gg, Hh^Fp, Hh, Hh^Fp, Ww, Hh, Ww, Hh, Hh^Fp, Gg, Hh, Gg, Gg, Gg, Gg, Gg, Ds, Ww, Ww, Wwf, Ww, Ww, Wo, Gg, Gg, Gg, Gg, Gs, Hh^Fms, Gs^Fms, Gg, Gg^Fms
Gg, Mm, Mm, Mm, Mm, Mm, Mm, Mm, Ww, Mm, Gg^Fp, Gg^Efm, Gg^Efm, Gg^Fp, Gg, Hh, Rb, Rb, Rb, Gg, Gg, Gll^Fp, Gg, Gll^Fp, Hh, Hh, Gg, Gg, Gg, Gs, Gg, Hh^Fp, Hh, Mm, Ww, Mm, Mm, Ww, Hh, Hh^Fp, Hh, Gg, Gg, Gg, Gg, Gs, Ds, Ww, Ww, Wwf, Wwf, Wwf, Wwf, Gg, Ds, Gg, Gg, Gg^Fms, Gg, Hh, Gg, Gg
Gg, Gg, Hh^Fp, Gg^Fp, Gs^Fp, Mm, Hh, Hh, Hh, Gg, Hh^Fp, Gg^Fp, Gg^Fet, Gg^Fp, Gg^Vo, Gg, Rb, Rb, Rb, Gg, Gg, Gs, Gg, Hh, Gg, Gg, Gg, Gll^Fp, Gll^Fp, Gg, Gg, Hh, Hh^Fp, Mm, Mm, Ww, Ww, Mm, Ww, Ww, Hh, Gg, Gg, Gs, Gg, Gg^Vo, Gg, Wo, Wwf, Wwf, Wwf, Ww, Wwf, Wo, Ww, Ds, Gs, Gs, Gs, Gg, Gg, Gg
Gg, Gg^Fp, Ww, Hh, Hh, Gg^Fp, Hh^Fp, Hh, Mm, Hh, Hh, Hh^Fp, Gg^Efm, Gg^Efm, Gg, Gg, Rb, Rb, Rb, Rb, Rb, Gg, Gs, Hh, Hh^Fms, Gs^Fms, Gs^Fms, Gg^Fet, Gg, Gll^Fp, Gg, Hh, Hh, Hh, Hh, Mm, Mm, Mm, Hh, Ww, Hh, Gg, Gg, Gg, Gg, Gg, Gg, Wwf, Ww, Wwf, Wwf, Wwf, Wo, Wo, Ww, Ww, Ww, Gs, Ss, Gs, Gg, Gg
Gg^Fp, Hh^Fp, Ww, Mm, Mm, Hh, Hh, Mm, Gg, Mm, Gg^Fp, Hh, Gg^Efm, Hh, Gg^Efm, Gg, Gg, Rb, Rb, Rb, Rb, Gs, Hh^Fms, Gs^Fms, Hh^Fms, Gg, Gs^Fms, Gg, Gll^Fp, Gll^Fp, Gg, Gs, Gs, Hh^Fp, Hh^Fp, Ww, Hh^Fp, Hh, Hh^Fp, Hh, Gg, Gg, Gg, Gg, Gg, Gg, Gg, Gg, Sm, Wo, Wwf, Wwf, Wo, Ww, Ww, Ww, Ww, Ss, Ss, Ss, Ss, Gg
Gg, Gg^Fp, Ww, Ww, Mm, Gg, Gs^Fp, Mm, Gg, Gg^Fp, Mm, Gg, Gg, Hh, Hh, Gg^Efm, Gg^Efm, Rb, Rb, Rb, Rb, Rb, Hh^Fp, Hh^Efm, Gll^Fp, Gg^Efm, Gg, Gs^Fms, Gg, Gg, Gg, Gg, Gg, Gs, Gs, Hh^Fp, Gg, Hh^Fp, Gg, Gg, Gg, Gg, Gg^Fms, Gg^Fms, Gg, Gg^Fms, Gg^Fms, Gg^Fms, Sm, Sm, Ww, Wo, Wo, Wo, Wo, Wo, Ww, Ww, Ww, Ss, Ww, Ss
Gg, Hh^Fp, Gg^Fp, Ww, Gg^Fp, Gg^Fp, Hh, Mm, Mm, Gg^Fp, Gg^Fp, Mm, Mm, Mm, Gg^Efm, Gg^Efm, Mm, Gg, Gg, Rb, Rb, Rb, Rb, Gg^Efm, Gg^Efm, Gg^Efm, Gg^Efm, Gg^Efm, Gg^Efm, Gg^Efm, Gg^Efm, Gg, Gg, Gg, Gg, Gg, Gg, Gg, Gg, Gg, Gg, Gg, Gg, Gg, Gg^Efm, Gg^Fet, Gg^Fms, Gg^Efm, Sm, Sm, Sm, Ww, Wo, Wo, Ww, Ww, Ww, Wo, Wo, Wo, Wo, Ww
Gg, Gg, Hh, Hh^Fp, Hh, Hh^Fp, Gg, Mm, Gg, Gg^Fp, Gg, Mm, Gg^Efm, Gg^Efm, Gg^Efm, Mm, Mm, Gg, Gg, Rb, Rb, Rb, Rb, Rb, Rb, Gg^Efm, Gg^Efm, Gg^Efm, Gg^Efm, Gg^Efm, Gg^Efm, Gg^Efm, Gg, Gg, Gg, Gg, Gg, Gg, Gg, Gg, Gg, Gg, Gg, Gg^Fms, Gg^Fms, Gg^Fms, Gg^Efm, Gg, Gg, Ss, Sm, Sm, Ss, Ww, Ww, Ww, Wo, Wo, Wo, Wo, Ww, Ww
