border_size=1
usage=map

Xu, Xu, Xu, Xu, Xu, Xu, Xu, Xu, Xu, Xu, Xu, Xu, Xu, Xu, Xu, Xu, Xu, Xu, Xu, Xu, Xu, Xu, Xu, Xu, Wog, Wog, Ss, Xu, Xu, Xu, Xu, Xu, Xu, Xu, Xu, Xu, Xu, Xu, Xu, Xu, Xu, Xu, Xu, Xu, Xu, Xu
Xu, Xu, Xu, Uu, Uu, Uu, Uu, Xu, Xu, Xu, Xu, Xu, Uu^Uf, Xu, Uu, Uu, Uu, Xu, Ur, Xu, Xu, Xu, Wog, Wog, Wog, Ss, Wog, Wog, Wog^Bw/r, Ur, Ur, Uu, Xu, Xu, Xu, Xu, Xu, Xu, Xu, Xu, Qxu, Xu, Xu, Xu, Xu, Xu
Xu, Xu, Uu, Xu, Xu, Uu^Uf, Xu, Uu, Uu, Xu, Xu, Xu, Uu^Uf, Xu, Uu, Xu, Ur, Ur, Xu, Ur, Ur, Xu, Wog, Wog, Wog^Bw\r, Ss^Vhs, Wog^Bw/r, Wog^Bw/r, Wwf, Wwf, Uu, Ur, Xu, Xu, Uu, Uu^Vud, Uu, Uu, Uu, Qxu, Qxu, Qxu, Qxu, Xu, Xu, Xu
Ur, Xu, 5 Uu, Uu, Xu, Xu, Qxu, Xu, Xu, Uu, Xu, Uu, Uu, Xu, Ur, Ur, Cud, Xu, Uu, Uu, Xu, Ur, Ur, Wog^Bw/r, Wwg, Wog^Bw\r, Wog, Wog, Wog, Wwf, Xu, Ur, Ur, Ur, Ur, Uu, Ur, Ur, Ur, Uu, Uu, Qxu, Qxu, Qxu, Xu, Xu
Xu, Ur, Ur, Xu, Ur, Qxu, Qxu, Xu, Uu, Xu, Uu, Uu, Ur, Ur, Xu, Uu, Cud, Kud, Cud, Xu, Ur, Ur, Sm, Wwg, Wog, Wwf, Sm, Ss^Vhs, Ss, Wog, Xu, Xu, Uu, Xu, Ur, Ur, Xu, Uu^Uf, Uh, Ur, Ur, Uu, Uu, Qxu, Uu, Xu
Xu, Xu, Uu^Uf, Ur, Xu, Ur, Ur, Xu, Xu, Uu, Ur, Ur, Uu, Xu, Uu^Vu, Xu, Uu^Uf, Uu^Uf, Ur, Ur, Xu, Xu, Wog, Wog, Wwf, Wwf, Wog, Sm, Wog, Wog, Xu, Uu^Uf, Xu, Xu, Uu, Ur, Xu, Xu, Xu, Xu, Xu, Ur, Ur, Uu, Ur, Ur
Xu, Xu, Xu, Xu, Xu, Xu, Ur, Uu, Xu, Uu, Ur, Uu, Uu, Uu^Uf, Uu^Uf, Xu, Xu, Ur, Uu, Xu, Wwg, Wwg, Wog, Wwf, Ss, Ss, Ss, Wog, Wog, Wog, Xu, Uu^Uf, Xu, Xu, Uu, Ur, Xu, Xu, Xu, Xu, Xu, Uu^Uf, Uu, Ur, Uu, Uu
Uu, Xu, Xu, Xu, Qxu, Xu, Uu, Ur, Ur, Uu, Ur, Uu, Xu, Xu, Xu, Xu, Uu, Ur, Uu, Ss, Wwg, Wwg, Wog, Wwf, Ss, Wog, Wog, Ss, Sm, Wog, Sm, Uu, Uu, Xu, Xu, Ur, Uh, Xu, Xu, Xu, Xu, Xu, Xu, Uu, Xu, Xu
Uu, Uu, Xu, Qxu, Xu, Xu, Xu, Xu, Uu, Ur, Xu, Xu, Xu, Xu, Uu^Vud, Uu, Xu, Ur, Xu, Ss, Wwg, Wog, Wog, Wwf, Ss, Ss^Vhs, Sm, Wog, Ss, Wog, Sm, Uu, Uh, Uu, Uu^Uf, Uh, Qxu, Qxu, Uu, Uu^Vud, Uu, Uu, Uu, Xu, Xu, Xu
Uu, Xu, Uu, Uu, Uu, Uu, Xuc, Uu, Uu, Ur, Xu, Xu, Xu, Xu, Xu, Uu^Uf, Xu, Ur, Xu, Ss, Wwg, Wog, Ss, Wog, Wog, Sm, Ss, Wwg, Ss, Wog, Sm, Xu, Xu, Xu, Uu, Uu^Uf, Uu, Qxu, Uu, Uu, Uu, Uu, Uu, Uu, Uu, Uu
Uu, Uu, Xu, Xu, Xu, Xu, Xu, Uu, Xu, Ur, Cud, Xu, Uu^Emf, Xu, Xu, Xu, Ur, Ur, Uu, Sm, Sm, Wog, Wog, Ss, Wwg, Wwg, Ss, Wog, Ss, Wog, Wwg, Xu, Uu, Uu, Uu^Uf, Uu, Cud, Uu, Cud, Cud, Cud, Uu, Uu, Uu, Ur, Ur
Xu, Xu, Uu, Uu, Uu^Uf, Xu, Xu, Uu, Xu, Ur, Uu, Uu^Emf, Uu^Emf, Kud, Cud, Uu, Ur, Uu^Uf, Uu^Uf, Sm, Xu, Wog, Wog, Wwf, Wwg, Wwf, Wwg, Wwg, Wog, Wog, Wwg, Xu, Uu, Uu^Vud, Ur, Ur, Cud, Cud, 3 Kud, Cud, Cud, Uu, Ur, Ur, Uu, Uu
Uu, Uu, Xu, Uu, Xu, Uu^Uf, Xu, Uu^Vud, Uu, Ur, Xu, Xu, Xu, Cud, Ur, Ur, Ur, Xu, Xu, Xu, Uu, Uu, Wog, Wog, Wwg, Wog, Wwf, Wwf, Wog, Wwg, Wwf, Xu, Cud, Uu, Ur, Ur, Ur, Cud, Cud, Cud, Uu^Br|, Ur, Xu, Xu, Uu, Uu
Uu, Xu, Xu, Xu, Uu, Xu, Xu, Xu, Xu, Ur, Ur, Xu, Ur, Ur, Xu, Xu, Ur, Uu, Xu, Xu, Xu, Uu, Wwg, Wog, Ss, Ss, Wwg, Wog, Wog, Sm, Wwf, Uu, Ur, Uu, Ur, Ur, Uu^Uf, Ur, Uu, Cud, Uu^Br|, Ur, Xu, Xu, Uu, Uu
Xu, Xu, Uu, Uu, Xu, Xu, Uu^Uf, Uu, Xu, Xu, Uu, Ur, Uu, Uu, Xu, Uu, Uu, Ur, Xu, Xu, Uu^Uf, Xu, Wwg, Wog, Wog, Wwg, Wog, Wog, Wwg, Sm, Wwf^Bsb/, Ur, Uu, Ur, Cud, Uu, Uu, Uh, Uh, Uu, Uu^Br|, Uu, Xu, Uu, Uu, Uu
Xu, Uu^Uf, Uu, Xu, Xu, Uu, Uu, Uu, Xu, Uu, Uu, Ur, Xu, Xu, Xu, Xu, Uu^Uf, Ur, Ur, Uu^Uf, Uu, Uu, Uu, Wwg, Wog, Wog, Wwg, Ss, Wwf^Bsb/, Wwf^Bsb/, Wwf, Wwf, Wwf, Uu, Uu, Uu, Qxu, Xu, Uu, Uu, Uu^Br|, Uu, Xu, Xu, Xu, Uu
Xu, Uu^Uf, Uu, Xu, Uu, Uu^Uf, Xu, Xu, Xu, Uu, Uu, Ur, Uu^Vud, Uu, Uu, Xu, Xu, Xu, Ur, Uu, Xu, Xu, Uu, Uu, Wwf, Wwf, Wwf^Bsb/, Wwf^Bsb/, Wwf, Wwf, Wwf, Wwf, Wwf, Uu, Uu, Uu, Qxu, Xu, Uu^Vud, Uu, Uu^Br|, Uu^Uf, Uu, Xu, Xu, Urb
Xu, Xu, Uu, Xu, Uu, Uu, Uu, Uu, Xu, Xu, Qxu, Ur, Ur, Xu, Xu, Uu, Xu, Uu, Ur, Cud, Cud, Xu, Uu, Uu, Wwf^Bsb/, Wwf^Bsb/, Wwf, Wwf, Wwf, Wwg, Wog, Wog, Wog, Uu, Uu^Uf, Qxu, Uu, Xu, Xu, Xu, Uu^Br|, Uu^Uf, Uu^Uf, Uu, Uu^Uf, Uu
Xu, Xu, Uu, Xu, Uu, Xu, Xu, Uu, Qxu, Xu, Uu, Qxu, Uu, Ur, Ur, Xu, Uu, Ur, Uu, Kud, Cud, Uu, Ur, Wwf^Bsb/, Wwf, Wwf, Wwg, Wwg, Wwf, Sm, Ss, Wog, Wwg, Wwg, Uu, Uu^Uf, Uu, Uu, Uu, Uu, Uu^Br/, Uu, Uu, Uu^Uf, Uu^Uf, Uu
Xu, Xu, Uu, Xu, Xu, Xu, Xu, Xu, Ur, Ur, Xu, Xu, Xu, Xu, Ur, Uu^Uf, Ur, Ur, Ur, Ur, Ur, Ur, Ur, Wwf, Wog, Wwg, Wog, Ss, Wog, Wog, Wog, Sm, Sm, Wog, Wog, Uu, Xu, Uu, Uu^Br|, Uu^Br/, Uu, Uu, Xu, Uu, Uu, Uu
Xu, Xu, Uu, Uu, Uu, Uu, Xu, Ur, Uu, Uu, Xu, Uu, Qxu, Uu, Ur, Ur, Ur, Uu^Vud, Xu, Xu, Xu, Uu, Uu, Wwf, Wog, Wog, Ss, Wog, Sm, Sm, Sm, Sm, Wog, Sm, Wwg, Xu, Xu, Xu, Uu^Br|, Uu, Uh, Xu, Xu, Xu, Xu, Xu
Xu, Xu, Xu, Uu, Xu, Xu, Uu^Uf, Ur, Xu, Xu, Qxu, Qxu, Xu, Xu, Ur, Uu, Uu, Ur, Ur, Xu, Uu^Uf, Uu, Uh, Ur, Wog, Wwf, Wwf, Ss, Chw, 2 Khw, Wwg, Wwg, Wwg, Wog, Wwg, Xu, Xu, Xu, Uu^Br|, Uu, Xu, Xu, Uu, Uh, Uu, Xu
Uu, Uu, Uu, Uu, Uu, Xu, Xu, Ur, Uu, Uu, Xu, Uu, Uh, Ur, Uu^Vud, Uu, Xu, Uu, Uu, Ur, Ur, Uu, Uh, Ur, Uh, Wog, Wog, Wwf, Wwf, Chs, Wwg, Ss, Ss, Wog, Wog, Xu, Uu, Xu, Uu, Uu^Br\, Uu^Br\, Uu, Uu^Uf, Uu, Ur, Ur
Uu, Uu, Uu, Xu, Uu, Xu, Xu, Xu, Qxu, Uu, Xu, Uu, Ur, Ur, Xu, Qxu, Qxu, Xu, Xuc, Xuc, Ur, Uu, Ur, Ur, Xu, Xu, Xu, Wog, Wog, Ss, Wwf, Wwf, Wwf, Wog, Wog, Wog, Uu^Uf, Xu, Xu, Uu, Uu, Uu^Br\, Uu^Br|, Ur, Ur, Ur
Xu, Uu^Uf, Uu, Xu, Xu, Xu, Uu, Xu, Qxu, Qxu, Xuc, Uu, Ur, Ur, Qxu, Qxu, Xu, Qxu, Uh, Uu, Ur, Ur, Uu, Uu^Vud, Xu, Xu, Xu, Uu, Wog, Wog, Wog, Ss, Wog, Ss, Wog, Xu, Xu, Xu, Qxu, Uu^Uf, Uu^Uf, Uu, Uu^Br|, Ur, Uu, Uu
Xu, Uu^Uf, Xu, Uu, Xuc, Uu, Uu, Uu, Uu, Uu, Xu, Uu, Ur, Qxu, Qxu, Uu^Ufi, Uu, Cud, Uu, Uu^Vud, Ur, Uu, Uh, Uh, Xu, Xu, Ur, Uh, Uu, Wog, Wwf, Wwg, Sm, Sm, Wwg, Xu, Xu, Qxu, Uh, Uh, Uu^Br/, Uu^Br/, Xu, Xu, Xu, Xu
Xu, Xu, Xu, Xu, Xu, Uu, Uu, Uu, Xu, Xu, Uu, Xu, Uu, Uu, Uu, Uu, Uh, Uu, Ur, Ur, Uu, Uu, Cud, Xu, Ur, Ur, Xu, Ur, Ur, Ur, Wog^Bsb\, Wwf, Wwg, Ss, Wog, Xu, Uu^Vud, Uu, Uu, Uu, Uu^Br|, Xu, Xu, Xu, Xu, Xu
Xu, Uu, Uu, Uu, Uu, Uu, Xu, Uu, Xu, Xu, Ur, Ur, Ur, Uu, Uu^Uf, Uu, Ur, Ur, Ur, Wwf, Cud, Kud, Cud, Cud, Xu, Xu, Uu^Vud, Uu, Ur, Wog, Wog, Wog^Bsb\, Wog^Bsb\, Wwg, Wwf, Wwf, Uu, Uu, Uu^Uf, Uu, Uu^Br|, Uu, Uu^Vud, Xu, Xu, Xu
Xu, Xu, Xu, Uu, Xu, Uu, Xu, Xu, Xu, Uu^Vud, Xu, Xu, Uu, Ur, Ur, Ur, Uu^Vud, Ur, Wwf, Ur, Ur, Cud, Wwf, Uu, Uu^Uf, Xu, Ur, Ur, Ur, Wwg, Wwg, Ss, Ss, Wog^Bsb\, Wog^Bsb\, Wwf, Uu, Cud, Ur, Ur, Cud, Uu, Uu, Xu, Qxu, Xu
Xu, Xu, Xu, Xu, Xu, Xu, Xu, Xu, Uu, Uu, Uu^Ii, Uu, Ur, Uh, Ur, Ur, Ur, Wwf, Wwf, Xu, Xu, Uu, Wwf, Ur, Ur, Ur, Uu, Uu, Wog, Wog^Bsb\, Wog^Bsb\, Wog, Ss, Wwg, Wo, Wog^Bsb\, Ur, Ur, Ur, Cud, 4 Kud, Cud, Uu, Qxu, Ur, Uu
Xu, Xu, Uu^Ii, Uu^Ii, Uu^Ii, Uu^Ii, Uu^Ii, Uu, Uu^Ii, Uu^Ii, Uu, Uu^Ii, Ur, Ur, Uu, Uu, Uu^Uf, Ur, Ur, Xu, Wwf, Xu, Ur, Wwf^Bw/r, Wwf, Uu^Vud, Uu, Wog, Wog, Wwf, Wwf, Wog^Bsb\, Wog^Bsb\, Ww, Ww, Wwf, Uu, Ur, Ur, Cud, Cud, Cud, Ur, Ur, Uu, Ur
Xu, Xu, Uu^Ii, Uu^Ii, Uu^Vud, Uu^Ii, Ce^Ii, Ce, Ce, Ur, Ur, Ur, Uu^Ii, Uu^Ii, Xu, Xu, Xu, Uu, Xu, Ur, Ur, Ur, Qxu, Ur, Qxu, Wwf, Wwf, Wog, Wwf, Wwf, Wwf, Wwf, Wog, Wog^Bsb\, Wog^Bsb\, Ww, Uu, Cud, Ur, Ur, Uu, Uu, Uu^Uf, Uu, Uu, Xu
Xu, Xu, Uu^Ii, Uu^Ii, Ur^Ii, Uu^Ii, Ce, 1 Ke^Ii, Ce^Ii, Uu^Ii, Uu^Ii, Uu^Vud, Uu^Ii, Uh, Xu, Xu, Xu, Xu, Uu^Vud, Ur, Uu, Qxu, Uu, Qxu, Qxu, Ur, Uu, Wog, Wwf, Wog, Ss, Ss, Wwf, Wog, Wwf, Ur, Ur, Ur, Uu, Uu^Uf, Uh, Uh, Xu, Xu, Uu, Xu
Ur^Ii, Ur^Ii, Ur^Ii, Ur^Ii, Uu^Ii, Ur^Ii, Uu^Ii, Ce, Uu^Ii, Uu, Uu^Ii, Uu, Uu, Xu, Xu, Xu, Xu, Xu, Xu, Xu, Xu, Qxu, Uu, Qxu, Qxu, Ur, Uu, Wog, Wog, Ss, Wog, Wog, Ww, Ww, Wwf, Wwf, Uu, Uu^Vud, Xu, Uh, Xu, Xu, Xu, Uu^Vud, Xu, Xu
Uu^Ii, Uu^Ii, Uu^Ii, Uu^Ii, Uu, Uu^Ii, Uu^Ii, Uu^Ii, Uu^Ii, Uu^Ii, Uu, Uu, Uu^Ii, Xu, Xu, Xu, Xu, Xu, Xu, Xu, Xu, Uu, Uu, Uu, Qxu, Ur, Uu, Wog, Wog, Ss, Ss, Ww, Wog, Wwf, Wog, Wog, Uu, Xu, Xu, Xu, Xu, Xu, Xu, Xu, Xu, Xu
