border_size=1
usage=map

Xu, Xu, Xu, Xu, Xu, Xu, Xu, Xu, Xu, Xu, Xu, Xu, Xu, Xu, Xu, Xu, Xu, Gd, Ms^Xm, Ms^Xm, Ms^Xm, Ms^Xm, Ms^Xm, Ms^Xm, Ms^Xm, Ms^Xm, Ms, Ms, Ms, Ms, Ha, Ha, Ha^Fpa, Gd, Aa, Aa, Aa, Aa, Aa^Fma, Ha^Fma, Ha, Ha, Ha^Fma, Ms^Xm, Ms^Xm, Gd, Ms, Ms, Ms, Ms, Ms, Ms, Ms, Ms, Ms, Ms^Xm, Ms^Xm, Ms^Xm, Ms^Xm, Gd, Ms^Xm, Gd, Ms^Xm, Ms^Xm, Ms^Xm, Ms, Ms, Ms, Ms, Ms
Xu, Xu, Xu, Xu, Xu, Xu, Xu, Xu, Xu, Xu, Xu, Xu, Xu, Xu, Xu, Xu, Ms^Xm, Ms^Xm, Ms^Xm, Ms^Xm, Ms^Xm, Ms^Xm, Ms, Ms^Xm, Ms^Xm, Ms^Xm, Ms, Ms, Ms, Ms, Ha, Ha, Ha, Aa, Aa, Aa, Aa, Aa, Aa, Ha^Fma, Ha^Fma, Ha^Fma, Ha^Fma, Ha, Ms^Xm, Ms^Xm, Ms^Xm, Ms, Ms, Ms, Ms, Ms, Ms, Ms, Ms, Ms^Xm, Ms^Xm, Ms^Xm, Ai, Ms^Xm, Ms^Xm, Ms^Xm, Ms^Xm, Ms^Xm, Ms^Xm, Ms, Ms, Ms, Ha, Ha
Xu, Xu, Xu, Xu, Xu, Xu, Xu, Xu, Xu, Xu, Xu, Xu, Xu, Xu, Xu, Xu, Ms^Xm, Ms^Xm, Ms^Xm, Ms^Xm, Ms, Ms, Ms, Ms, Ms, Ms^Xm, Ms^Xm, Ms, Ms, Ms, Ha, Ha^Fpa, Ha^Fpa, Ha^Voa, Gd, Gd, Aa, Aa, Aa, Aa, Aa, Ha, Ha^Fma, Ha, Ha, Ms^Xm, Ms^Xm, Ms^Xm, Ms^Xm, Ms, Ha, Ms, Ms, Ms, Ms, Ms, Ms, Ai, Ms^Xm, Ms^Xm, Ms^Xm, Ms^Xm, Ms^Xm, Ms^Xm, Ms, Ms^Xm, Ms^Xm, Ms, Ha^Fpa, Ha^Fpa
Xu, Xu, Xu, Xu, Xu, Xu, Xu, Xu, Xu, Xu, Xu, Xu, Gd, Xu, Xu, Xu, Xu, Ms^Xm, Ms^Xm, Ms^Xm, Ms, Ms, Ms, Ms, Ms, Ms, Ms, Ms, Ms, Ms, Ms, Ha, Ha^Fpa, Ha^Fpa, Ha, Gd, Gd, Aa, Aa, Gd, Aa, Aa, Ha^Fma, Ha, Ha, Ms^Xm, Ms^Xm, Ms^Xm, Ms^Xm, Ha, Ha, Ha, Ha, Ms, Ms, Ms, Ai, Ai, Ms, Ms^Xm, Ms, Ms^Xm, Ms^Xm, Ms, Ms, Ms, Ms^Xm, Ms^Xm, Ha^Fpa, Ha^Fpa
Xu, Xu, Xu, Xu, Xu, Xu, Xu, Xu, Xu, Xu, Xu, Gd, Gd, Gd, Xu, Xu, Xu, Xu, Xu, Xu, Ha, Ha, Ha, Ms, Ms, Ms, Ms, Ms, Ms, Ms, Ms, Ha, Ha, Ha^Fpa, Ha^Fpa, Gd, Aa, Aa, Aa, Gd, Aa, Ha, Ha^Vha, Ha^Fma, Ha, Ms^Xm, Ms^Xm, Ms^Xm, Ms^Xm, Ha, Ha^Fpa, Ha^Fpa, Ha, Ms, Ai, Ai, Ms, Ms, Ms, Ms, Ms, Ms, Ms, Ms, Ms, Ms, Ms^Xm, Ha, Ha^Fpa, Ha^Fpa
Xu, Xu, Xu, Xu, Xu, Xu, Gd, Xu, Xu, Xu, Gd, Gd, Gd, Gd, Xu, Xu, Xu, Xu, Xu, Xu, Ha, Ha^Fpa, Ha^Fma, Ha, Ms, Ms, Ms, Ms, Ms^Xm, Ms, Ms, Ms, Ha, Ha^Fpa, Ha, Ha, Gd, Gd, Gd, Aa, Aa, Aa, Ha, Ha, Ha, Ms, Ms^Xm, Ms^Xm, Ms, Ha, Aa^Fpa, Ha, Ai, Ai, Ha, Ha^Vha, Aa, Ms, Ms, Ms, Ms, Ms, Ms, Ms, Ms, Ms, Ha, Aa, Ha^Fpa, Ha
Xu, Xu, Gd, Xu, Gd, Gd, Gd, Gd, Gd, Gd, Gd, Gd, Gd, Gd, Gd, Xu, Xu, Xu, Xu, Xu, Aa, Ha, Aa^Fma, Ha^Fma, Ha, Ms, Ha, Ms, Ha, Ha, Ha, Ha, Ha^Fpa, Ha^Fpa, Ha, Aa, Aa, Gd, Aa, Aa, Aa, Aa, Aa, Aa, Ha, Ha, Ha, Ha, Ha, Ha^Fpa, Aa^Fpa, Ai, Ha, Ha^Fpa, Aa, Aa, Cha, Ha, Ha, Ha^Fma, Ha^Fma, Ms, Ms, Ms, Ms, Ha, Ha^Fpa, Ha^Fpa, Aa^Fpa, Aa
Gd, Gd, Aa, Gd, Gd, Gd, Aa, Gd, Gd, Ai, Aa, Gd, Xu, Xu, Xu, Xu, Xu, Xu, Xu, Xu, Aa, Aa, Aa, Aa^Fma, Ha^Fma, Ha, Ha, Ha, Aa, Ha, Aa, Ha, Aa, Ha^Fpa, Aa, Aa, Gd, Gd, Gd, Aa, Wwf, Aa, Ha, Aa, Aa, Ha, Aa, Ha, Ha, Ms, Ai, Ai, Ha, Aa, Cha, Cha, Cha, Cha, Cha, Ha, Ha, Ha^Fma, Ha^Fma, Ms, Aa, Aa, Ha^Fma, Aa, Ha, Ha
Gd, Aa, Aa, Aa, Aa, Gd, Aa, Aa, Aa, Ai, Ai, Xu, Xu, Xu, Xu, Xu, Xu, Xu, Xu, Xu, Aa, Aa, Aa^Fpa, Ha, Ha, Ha^Fma, Ha^Fma, Ha^Fma, Ha^Voa, Aa, Ha, Aa, Aa, Ha^Fpa, Ai, Aa, Gd, Ha, Ha, Sm, Aa, Wwf, Gd, Ha, Ha, Aa, Aa, Aa, Aa, Ai, Ai, Ai, Gd, Cha, Cha, Cha, Cha, 2 Kha, Cha, Cha, Cha, Ha, Ha, Ha^Fma, Ha^Fpa, Ha^Fma, Ha^Fpa, Aa, Gd, Gd
Gd, Aa, Gd, Gd, Aa, Aa, Aa, Aa, Aa, Ai, Gd, Xu, Xu, Xu, Xu, Xu, Xu, Xu, Xu, Xu, Aa, Aa^Fpa, Gd, Gd, Gd, Ha, Gd, Ha, Gd, Gd, Gd, Gd, Sm, Sm, Wwf, Gd, Ha, Ha, Ha, Gd, Gd, Gd, Aa, Gd, Ai, Ai, Aa, Aa^Vha, Gd, Ai, Ai, Ai, Aa, Aa, Gd, Cha, Cha, Cha, Cha, Cha, Gd, Ha, Ha, Ha^Vha, Ha, Ha^Fpa, Gd, Gd, Gd, Gd
Gd, Gd, Gd, Gd, Aa, Aa, Aa, Aa, Aa, Aa, Gd, Gd, Gd, Xu, Ha, Xu, Ha, Xu, Gd, Gd, Aa^Fpa, Aa, Gd, Gd, Gd, Gd, Aa, Gd, Aa^Fma, Gd, Gd, Gd, Gd, Wwf, Wwf, Gd, Gd, Ha, Ha, Ha, Ha^Fpa, Aa^Fpa, Sm, Aa, Ss, Wwf, Wwf, Gd, Gd, Gd, Aa, Aa, Gd, Gd, Aa, Gd, Aa, Cha, Aa, Aa, Gd, Ha, Ha, Ha, Ha, Aa, Aa, Aa, Gd, Gd
Xu, Gd, Gd, Gd, Gd, Gd, Ai, Ai, Aa, Aa, Aa, Aa, Ai, Ha, Ha, Ha, Ha, Gd, Ai, Aa, Aa, Aa^Fpa, Gd, Aa, Gd, Aa, Aa, Gd, Aa^Fma, Aa, Aa, Aa, Gd^Fpa, Gd^Fpa, Aa^Fpa, Aa^Fpa, Aa^Fpa, Aa, Aa, Ha, Aa^Fpa, Ha, Ai, Sm, Ss, Wwf, Aa, Gd, Sm, Gd, Gd, Aa, Gd, Aa, Aa, Ss, Sm, Aa, Gd, Aa, Gd, Gd, Gd, Aa, Aa, Gd, Ha, Ha, Aa, Ms
Xu, Xu, Xu, Xu, Xu, Gd, Gd, Ai, Ai, Gd, Aa, Ai, Ai, Gd, Gd, Aa, Ai, Ai, Ai, Aa, Gd^Fpa, Aa, Aa, Gd, Gd, Gd, Gd, Gd, Ha^Fpa, Aa^Fma, Aa^Fma, Aa^Fma, Ha^Fpa, Ha^Fpa, Gd, Aa, Gd^Fpa, Gd^Fpa, Gd, Aa, Aa, Ai, Wwf, Ai, Wwf, Ai, Gd, Sm, Gd, Aa, Aa, Wwf, Wwf, Aa, Wwf, Wwf, Wwf, Sm, Aa, Gd, Gd, Gd, Aa^Fma, Aa, Ha^Fma, Gd^Fma, Aa, Ha, Ha, Ha
Xu, Xu, Xu, Xu, Xu, Xu, Xu, Ai, Gd, Gd, Gd, Ai, Aa, Gd, Aa, Gd, Aa, Ai, Aa^Fpa, Aa^Fpa, Aa^Fpa, Aa, Aa, Gd, Aa, Gd, Ha, Ha, Ha^Fpa, Aa^Fpa, Aa, Gd^Fpa, Ha, Ha^Fpa, Aa, Aa, Ss, Gd, Gd, Gd, Aa, Gd, Aa, Wwf, Aa, Gd, Aa, Gd, Sm, Sm, Ai, Aa, Ha, Aa, Ha^Fpa, Ai, Aa, Aa, Gd, Gd, Aa, Gd^Fma, Ha, Ha, Aa, Ha^Fma, Aa, Aa, Ha, Ha
Xu, Xu, Xu, Xu, Xu, Xu, Xu, Xu, Xu, Gd, Gd, Gd, Gd, Aa, Gd, Gd, Aa, Gd, Aa, Ha, Gd^Fpa, Gd, Ha, Ha, Ha, Ha, Gd, Aa, Aa, Gd, Aa, Gd, Gd^Fpa, Gd^Fpa, Aa, Ai, Wwf, Wwf, Ai, Gd, Ha^Fma, Aa^Fma, Ha^Fma, Aa^Fma, Ha^Fma, Gd, Aa, Aa, Ai, Wwf, Wwf, Ai, Gd, Ha, Ha^Fpa, Aa^Fpa, Aa^Fpa, Gd, Gd, Gd, Aa, Aa, Aa, Aa, Aa, Ha, Ha, Ha, Ms, Ms
Xu, Xu, Xu, Xu, Xu, Xu, Xu, Xu, Xu, Xu, Xu, Xu, Xu, Gd, Gd, Gd, Aa, Aa, Gd, Gd, Aa, Aa, Aa, Aa, Aa, Gd, Aa, Gd, Wwf, Aa, Aa^Voa, Gd, Aa, Aa, Ss, Ai, Sm, Wwf, Aa, Gd^Fma, Gd^Fma, Aa, Aa, Ha^Fma, Aa^Fma, Aa, Ha, Gd, Ai, Wwf, Sm, Sm, Aa, Gd, Gd, Aa^Fpa, Gd, Gd, Gd, Ha^Vha, Ha, Ha, Aa, Aa, Ms, Ms, Ms, Ms, Ms^Xm, Ms^Xm
Xu, Xu, Xu, Xu, Xu, Xu, Xu, Xu, Xu, Xu, Xu, Xu, Xu, Xu, Gd, Gd, Gd, Aa, Aa, Aa^Fma, Gd^Fma, Aa^Fma, Gd, Aa^Fma, Ha, Aa^Fma, Gd, Wwf, Ss, Gd, Gd, Gd, Gd, Aa, Gd, Sm, Aa, Aa, Sm, Gd, Aa, Gd^Voa, Gd, Gd, Gd, Ha, Gd, Aa^Fma, Aa, Aa^Fma, Aa, Aa, Aa, Ss, Wwf, Ss, Gd, Gd, Ha, Ha, Ha^Fpa, Ha^Fpa, Ha, Aa, Ms, Ms, Ms, Ms, Ms, Ms^Xm
Xu, Xu, Xu, Xu, Xu, Xu, Xu, Xu, Xu, Xu, Xu, Xu, Xu, Xu, Gd, Gd, Aa, Aa^Voa, Aa, Aa^Fma, Aa, Aa, Gd, Gd, Ha, Ha, Ha, Ss, Ss, Sm, Sm, Gd, Gd, Aa, Aa^Fpa, Aa^Fpa, Aa^Fpa, Aa, Aa^Fpa, Aa, Aa, Aa, Aa, Aa, Sm, Gd, Gd, Aa, Aa, Aa^Fma, Aa^Fma, Aa^Fma, Gd, Ss, Wwf, Wwf, Gd, Gd, Ha, Ha, Ha, Ha, Ha^Fpa, Ms, Ms, Ms, Ms, Ms, Ms, Ms^Xm
Xu, Xu, Xu, Xu, Xu, Xu, Xu, Xu, Xu, Xu, Xu, Xu, Xu, Xu, Aa, Aa, Aa, Aa, Aa, Aa, Aa, Aa, Gd, Gd, Aa^Fpa, Aa^Fpa, Ha, Aa^Fpa, Aa^Fpa, Sm, Gd, Wwf, Gd, Aa^Fpa, Ha, Ha, Aa, Sm, Aa^Fpa, Aa, Gd, Aa, Gd, Sm, Ss, Sm, Sm, Aa^Fma, Ha^Fma, Aa^Fma, Aa^Fma, Gd, Aa, Aa, Aa^Fma, Gd, Sm, Wwf, Ai, Ha, Ha, Ha^Fpa, Aa, Ha, Ha, Ms, Ms, Ms, Ms, Ms^Xm
Xu, Xu, Xu, Xu, Xu, Xu, Xu, Xu, Xu, Xu, Xu, Xu, Ha, Gd, Aa, Aa, Gd, Aa, Aa, Gd, Gd, Gd, Gd, Aa^Voa, Aa, Aa^Fpa, Aa^Fpa, Ha^Fpa, Wwf, Ai, Gd, Gd, Gd, Aa, Aa, Ha, Ha, Ha, Aa^Fpa, Gd, Gd, Aa, Gd, Sm, Sm, Ss, Aa, Gd, Ha, Ha, Aa^Fma, Gd, Ha, Gd^Vha, Aa, Aa, Ai, Ai, Aa^Fpa, Aa, Aa^Fpa, Ha^Fpa, Ha^Fpa, Aa, Aa, Ha, Ha, Ms, Ms, Ms^Xm
Wwf, Xu, Xu, Xu, Xu, Xu, Xu, Xu, Xu, Xu, Aa, Aa, Ha, Ha, Aa^Fma, Gd^Fma, Aa, Aa, Aa, Aa, Gd, Wwf, Wwf, Gd, Gd, Gd, Aa, Ai, Wwf, Wwf, Aa, Gd, Aa, Aa, Aa, Aa, Ai, Aa^Fpa, Aa^Fpa, Aa, Aa, Gd, Wwf, Gd, Gd, Aa^Fpa, Ha^Fpa, Ha, Ha^Fpa, Ha^Fma, Aa, Aa, Aa^Fma, Ha^Fpa, Ha^Fma, Aa^Fpa, Ha, Ai, Gd, Gd, Aa, Aa, Gd^Fpa, Ha, Ha^Fpa, Aa, Ha, Ms, Ms, Ms
Wwf, Wwf, Wwf, Xu, Xu, Xu, Xu, Xu, Ha, Ha, Aa, Ha, Gd, Aa, Aa^Fma, Aa^Fma, Aa^Fma, Aa, Gd, Aa, Gd, Wwf, Gd, Ai, Coa, Coa, Coa, Gd, Aa, Gd, Gd, Gd, Aa, Aa, Ss, Ai, Wwf, Wwf, Aa, Aa, Gd, Wwf, Sm, Sm, Aa, Gd, Aa^Fma, Gd, Aa, Ha^Fpa, Aa^Fpa, Aa^Fpa, Aa^Fma, Ha^Fma, Ha^Fma, Ha, Aa^Fma, Ha^Fma, Ha, Ha, Ha, Ha, Ha, Gd^Fpa, Ha^Fpa, Ha, Ha, Ha, Ha, Ms
Gd, Wwf, Aa, Aa, Aa, Xu, Aa, Xu, Gd, Aa, Wwf, Aa, Gd, Gd, Gd, Aa, Sm, Aa, Ha, Ha, Gd, Ai, Coa, Coa, Coa, Coa, Coa, Coa, Gd, Aa, Gd, Aa, Gd, Aa, Sm, Ss, Aa, Wwf, Aa, Gd, Gd, Aa, Gd, Ss, Gd, Wwf, Wwf, Gd, Gd, Aa^Fpa, Aa^Fpa, Aa^Fpa, Ha^Fpa, Ha^Fpa, Ha, Ha^Fma, Ha, Aa^Fma, Aa^Fma, Aa^Fma, Gd, Ha, Aa^Fma, Aa, Aa, Ha, Ha^Fpa, Ha, Ha, Ha
Ss, Gd, Wwf, Aa, Aa, Aa, Wwf, Wwf, Aa, Wwf, Aa, Aa, Aa, Gd, Sm, Wwf, Wwf, Sm, Ha, Aa, Aa, Aa, Coa, 1 Koa, Coa, Coa, Coa, Coa, Aa, Aa, Gd, Gd, Gd, Aa, Gd, Aa, Gd^Fpa, Gd, Gd, Gd, Aa, Aa, Sm, Sm, Wwf, Wwf, Gd, Aa, Aa^Fpa, Aa^Fma, Ha^Fma, Ha^Fma, Ha, Aa, Aa, Aa, Aa, Aa^Fma, Aa, Gd, Aa, Aa^Fma, Aa, Gd, Aa, Gd, Ha, Ha^Fpa, Ha, Ha
Xu, Ss, Ai, Wwf, Gd, Aa, Aa, Ai, Gd, Gd, Gd, Wwf, Wwf, Aa, Aa, Sm, Aa, Wwf, Gd, Aa, Aa^Voa, Aa, Ss, Coa, Coa, Coa, Aa, Aa, Aa, Aa, Ai, Wwf, Ss, Gd, Gd, Aa^Fpa, Sm, Gd^Fpa, Gd, Aa, Aa, Ss, Sm, Sm, Aa, Aa, Aa, Aa^Fpa, Aa^Fpa, Gd, Gd, Gd, Ha^Fpa, Aa^Fpa, Ha^Fpa, Gd, Gd, Aa^Fma, Aa, Gd, Gd, Aa, Aa, Gd, Aa, Gd, Gd, Ha, Aa, Gd
Xu, Xu, Xu, Gd, Xu, Ss, Xu, Xu, Xu, Xu, Xu, Gd, Gd, Wwf, Wwf, Gd, Aa, Aa, Gd, Gd, Gd, Aa, Ss, Ss, Ss, Aa, Aa, Aa, Aa^Voa, Aa, Ai, Ai, Ss, Ss, Aa, Aa^Fpa, Aa^Fpa, Sm, Aa^Fpa, Aa^Fpa, Aa, Aa, Aa, Aa, Aa, Gd, Aa, Aa, Aa, Gd, Gd, Gd, Gd, Aa^Fpa, Aa^Fpa, Aa^Fpa, Aa^Fpa, Gd, Gd, Gd, Ai, Ai, Ai, Aa, Aa, Aa, Gd^Fpa, Aa, Gd, Gd
Xu, Xu, Xu, Xu, Xu, Xu, Xu, Xu, Xu, Xu, Xu, Gd, Wwf, Wwf, Aa, Gd, Aa^Fpa, Gd, Aa, Aa, Aa, Gd, Gd, Ss, Sm, Aa, Aa, Aa, Aa^Fma, Aa, Aa, Aa, Gd, Ss, Aa, Aa, Ha^Fpa, Aa^Fpa, Gd^Fpa, Gd, Aa, Wwf, Sm, Aa, Aa, Aa, Aa, Gd, Aa, Gd^Vha, Gd, Gd, Gd, Gd, Aa^Fpa, Aa, Aa^Fpa, Aa^Fpa, Gd, Gd, Ai, Ai, Ha, Ai, Ha, Ha^Fpa, Ha^Fpa, Gd, Ha^Fpa, Gd
Xu, Xu, Xu, Xu, Xu, Xu, Xu, Xu, Xu, Xu, Xu, Gd, Gd, Wwf, Aa, Aa^Fpa, Ha^Fpa, Gd^Fpa, Aa, Aa, Aa, Aa, Gd, Sm, Aa, Aa^Fma, Aa^Fma, Aa, Aa^Fma, Aa, Gd, Aa, Aa, Ha, Aa, Ha, Ha, Gd^Voa, Gd, Aa, Sm, Wwf, Ss, Aa, Aa, Gd, Wwf, Wwf, Sm, Gd, Gd, Aa, Aa, Gd, Gd, Aa, Gd, Wwf, Aa, Gd, Aa, Ha, Ha^Vha, Ai, Ai, Ha^Fpa, Ai, Ha^Fpa, Ha^Fpa, Ha
Xu, Xu, Xu, Xu, Xu, Xu, Xu, Xu, Xu, Xu, Xu, Gd, Aa^Voa, Aa, Aa, Aa, Ha^Fma, Ha^Fpa, Ha^Fpa, Gd, Ha^Fpa, Aa, Gd, Gd, Aa, Aa, Aa^Fma, Aa, Aa^Fma, Gd, Wwf, Wwf, Aa, Ha, Gd^Fma, Aa, Aa, Aa, Aa^Fma, Gd, Ha^Fpa, Ha^Fpa, Aa^Fpa, Gd, Aa, Gd, Gd, Wwf, Ss, Ss, Aa, Aa, Aa^Fpa, Aa^Fpa, Aa^Fpa, Gd, Aa^Fpa, Gd, Aa, Ha, Ha^Fma, Aa^Fma, Ha, Ha, Ha, Ai, Ai, Ha, Ha, Ha
Xu, Xu, Xu, Xu, Gd, Gd, Gd, Gd, Gd, Xu, Gd, Gd, Gd, Aa, Aa, Aa, Aa^Fma, Ha, Aa, Ha, Ha^Fpa, Aa^Fpa, Aa, Aa, Aa, Aa, Gd, Aa^Fma, Aa, Sm, Ai, Ai, Aa, Ha^Fpa, Ha^Fpa, Ha^Fma, Ha^Fma, Aa^Fma, Aa^Fma, Ha^Fpa, Ha, Ha^Fpa, Aa, Aa, Aa, Aa, Aa, Aa, Aa, Ss, Sm, Aa, Gd, Aa^Fpa, Aa^Fpa, Aa^Fpa, Aa^Fpa, Aa, Ha, Ha, Ha^Fma, Ha, Ms, Ha, Ms, Ms, Ai, Ha, Ms, Ms
Xu, Xu, Xu, Xu, Gd, Gd, Ai, Gd, Gd, Gd, Ai, Gd, Gd, Gd^Fpa, Aa, Aa, Aa, Aa, Gd, Gd, Aa^Fpa, Ha^Fpa, Gd, Gd, Gd, Aa, Aa^Fma, Aa, Aa^Fma, Aa, Sm, Aa, Aa, Aa, Ss, Gd, Aa^Fpa, Aa^Fpa, Aa^Fma, Ha^Fma, Aa, Ha^Fpa, Aa, Aa, Aa, Gd, Gd, Aa, Ss, Ss, Wwf, Aa, Gd, Gd, Gd, Gd, Gd, Ha, Ha, Ha^Fma, Ha, Ha, Ms, Ms, Ms^Xm, Ms^Xm, Ms^Xm, Ms^Xm, Ms^Xm, Ms^Xm
Xu, Xu, Sm, Gd, Gd, Ai, Ai, Aa, Aa, Aa, Aa, Ai, Aa, Aa, Aa, Aa, Aa^Fpa, Aa, Gd, Aa^Fpa, Aa^Fpa, Aa^Fpa, Gd, Gd, Aa^Fma, Aa, Ha^Fma, Gd^Fma, Ha^Fma, Ha, Gd, Sm, Ai, Aa^Fma, Ai, Sm, Aa^Fpa, Aa^Fpa, Gd, Aa, Aa, Aa, Gd, Gd, Aa, Gd^Vha, Aa, Aa, Ai, Sm, Wwf, Wwf, Gd, Ai, Ss, Gd, Ha, Ha, Ha^Fma, Ha^Fma, Ms, Ms, Ms, Ms, Ms^Xm, Ms^Xm, Ms^Xm, Ms^Xm, Ms^Xm, Ms^Xm
Xu, Xu, Ss, Gd, Gd, Aa, Gd, Aa, Aa, Aa, Aa, Aa, Aa, Aa, Aa^Fpa, Aa^Fpa, Gd, Gd, Aa^Fpa, Gd, Gd, Gd, Aa^Fma, Aa^Fma, Ha^Fma, Ha^Fma, Ha^Fma, Gd^Fma, Ha, Ha, Ha, Gd, Sm, Wwf, Wwf, Ss, Ss, Gd, Gd, Aa, Aa, Aa, Aa, Aa, Aa, Ha, Aa, Ss, Gd, Ai, Gd, Gd, Aa, Ai, Ha, Ha, Ha, Ha^Fma, Aa^Vha, Ha, Ms, Ms, Ms^Xm, Ms^Xm, Ms^Xm, Ms^Xm, Ms^Xm, Ms^Xm, Ms^Xm, Ms^Xm
Xu, Xu, Ss, Gd, Gd, Aa, Aa, Aa, Aa, Aa, Aa, Aa^Fpa, Aa^Fpa, Gd, Gd^Fpa, Aa, Gd, Gd, Gd, Gd, Gd, Aa, Aa, Gd^Fma, Aa^Fma, Ha^Fma, Aa, Aa^Fma, Ai, Ha, Ha, Gd, Gd, Wwf, Wwf, Ss, Gd, Aa, Gd, Aa, Gd, Gd, Aa, Ha, Ha, Ha^Fma, Aa^Fma, Aa^Fma, Gd, Gd, Aa, Aa, Gd, Aa, Ha, Ha, Ha^Fpa, Ha^Fma, Aa^Fpa, Ha, Ha, Ms^Xm, Ms, Ms^Xm, Ms^Xm, Ms^Xm, Ms^Xm, Ms^Xm, Ms^Xm, Ms^Xm
Gd, Ss, Gd, Gd, Gd, Aa, Aa, Aa, Ha, Ha, Ha, Gd, Gd, Gd^Fpa, Aa, Gd, Gd, Gd, Ha, Ha^Fma, Ha, Ha, Aa, Aa, Aa, Gd, Ai, Ai, Ai, Ha, Ha, Ha, Gd, Gd, Gd, Gd, Gd, Gd, Gd, Gd, Gd, Gd, Aa, Gd, Aa^Fma, Aa^Fma, Gd, Gd, Gd, Gd, Gd, Aa, Cud, Aa, Aa, Ha^Fpa, Ha, Ha, Aa^Fpa, Ha^Fpa, Ha, Ms, Ms, Ms, Ms^Xm, Ms^Xm, Ms^Xm, Ms^Xm, Ms^Xm, Ms^Xm
Gd, Gd, Ss, Ss, Ai, Ai, Ha, Ha^Fma, Ha^Fma, Ha^Fma, Ha, Aa, Xu, Aa, Xu, Gd, Gd, Gd, Gd^Fma, Ha^Fma, Gd, Aa^Voa, Aa, Aa, Aa, Gd, Ai, Aa, Aa, Ha, Aa^Fpa, Gd, Aa^Fpa, Gd, Gd, Gd, Gd, Gd, Gd, Gd, Gd, Gd, Gd, Gd, Sm, Gd, Aa, Aa, Aa, Gd, Aa, Cud, Cud, Cud, Cud, Ha, Ha, Ha, Ha^Fpa, Ha, Ha, Ms, Ms, Ms, Ms, Ms^Xm, Ms^Xm, Ms^Xm, Ms^Xm, Ms^Xm
Gd, Gd, Ss, Ai, Aa, Ai, Ha, Ha^Fma, Ha^Fma, Ha^Fma, Ha, Xu, Xu, Xu, Xu, Gd, Xu, Gd, Xu, Gd, Gd, Gd, Aa, Aa, Gd, Gd, Ai, Aa, Aa^Fpa, Aa^Fpa, Aa, Aa^Fpa, Aa^Fpa, Gd, Ha, Ha, Ha, Ha, Ha, Gd, Ha^Voa, Gd, Sm, Sm, Sm, Gd, Gd, Gd, Gd, Aa, Aa, Cud, Cud, Cud, Cud, Cud, Cud, Ha, Ha^Fpa, Ha, Ms, Ms, Ms, Ms, Ms, Ms, Ms, Ms^Xm, Ms, Ms^Xm
Gd, Gd, Gd, Ss, Gd, Ha, Ss, Ha, Xu, Xu, Xu, Xu, Xu, Xu, Xu, Xu, Xu, Xu, Xu, Xu, Aa, Aa, Ha, Gd, Aa, Gd, Ai, Ai, Gd, Aa^Fpa, Gd, Aa, Aa, Ha, Aa, Aa, Ha^Fpa, Ha, Aa, Aa, Aa, Aa, Ai, Wwf, Gd, Gd, Gd, Gd, Aa, Aa, Aa, Cud, Cud, 3 Kud, Cud, Cud, Cud, Cud, Aa, Ha, Ha^Fpa, Ai, Ms, Ms, Ms, Ms, Ms, Ms, Ms, Ms
Gd, Gd, Gd, Gd, Xu, Xu, Xu, Xu, Xu, Xu, Xu, Xu, Xu, Xu, Ms^Xm, Xu, Xu, Xu, Ha, Ha, Ha^Fpa, Ha^Fpa, Ha, Ha, Aa, Aa, Ai, Gd, Aa, Aa, Ha^Voa, Ha, Ha, Aa, Ha^Fma, Ha^Fma, Ha^Fpa, Ha, Ha, Ha^Fma, Ha^Fma, Ha, Ha, Ai, Gd, Gd, Gd, Aa, Aa, Gd, Aa, Aa, Gd, Cud, Cud, Cud, Ha, Aa, Ha, Aa, Aa^Fpa, Ai, Ai, Ms, Ms, Ms, Ms, Ms, Ms, Ms
Xu, Gd, Gd, Xu, Xu, Xu, Xu, Xu, Xu, Xu, Xu, Xu, Ms^Xm, Ms^Xm, Ms^Xm, Ms^Xm, Ms^Xm, Xu, Ha^Fpa, Ha^Fpa, Ha^Fpa, Ha^Fpa, Ha^Fpa, Aa, Ha^Fma, Ha, Gd, Ai, Gd, Aa, Ha^Fpa, Aa^Fma, Ha^Fma, Ha^Fma, Ha, Ha^Fma, Ms, Ms, Ms, Ha, Ha^Fma, Ha^Fma, Ha, Aa, Gd, Aa, Gd, Aa, Aa, Aa, Gd, Gd, Gd, Aa, Ha, Ha, Ha, Ha, Ha, Ha^Vha, Ha, Aa^Fpa, Ha, Ai, Ms, Ms, Ms, Ms, Ms, Ms
Xu, Xu, Xu, Xu, Xu, Xu, Xu, Xu, Xu, Xu, Ms^Xm, Xu, Ms^Xm, Ms^Xm, Ms^Xm, Ms^Xm, Ms^Xm, Ms^Fpa, Ms^Fpa, Ha^Fpa, Ha, Ha^Fpa, Ms, Ha, Ha^Fma, Ha, Aa, Ai, Ha, Ha^Fpa, Ha, Aa^Fpa, Ms, Ha, Ms, Ms, Ms, Ms, Ms, Ha, Ha^Fma, Ha, Ha, Aa, Aa, Gd^Fpa, Aa^Fpa, Aa, Aa, Gd^Vha, Gd, Gd, Ha, Ha, Ha^Fma, Ha, Ms, Ms, Ms, Ha, Ms, Ha^Fpa, Ha, Ai, Ms, Ms, Ms, Ms, Ms^Xm, Aa
Xu, Xu, Xu, Xu, Xu, Xu, Xu, Xu, Xu, Ms^Xm, Ms^Xm, Ms^Xm, Ms^Xm, Ms^Xm, Ai, Ms^Xm, Ms^Xm, Ms^Fpa, Ms^Xm, Ms^Xm, Ms, Ms, Ms, Ha, Ha, Ha^Fpa, Ai, Ai, Ha, Ha^Fpa, Ha, Ms, Ms, Ms, Ms^Xm, Ms^Xm, Ms^Xm, Ms^Xm, Ms^Xm, Ha, Ha^Fpa, Ha^Fpa, Aa, Aa, Gd, Aa^Fpa, Aa, Aa^Fpa, Gd^Fpa, Aa^Fpa, Gd, Ha, Ha^Fma, Ha^Fma, Ha, Ha, Ms, Ms, Ms, Ms, Ms, Ms, Ms, Ai, Ai, Ms, Ms, Ms^Xm, Ms^Xm, Ms^Xm
Xu, Xu, Xu, Xu, Xu, Xu, Xu, Xu, Xu, Ms^Xm, Ms^Xm, Ms^Xm, Ms^Xm, Ai, Ai, Ai, Ms^Xm, Ms^Xm, Ms^Xm, Ms^Xm, Ms, Ms, Ms, Ms, Ms, Ai, Ai, Ai, Aa, Ha^Fpa, Ha, Ms, Ms, Ms, Ms^Xm, Ms^Xm, Ms^Xm, Ms^Xm, Ms^Xm, Ms, Ms, Ha^Fpa, Ha, Aa, Aa, Aa^Fpa, Aa^Fpa, Gd^Fpa, Gd, Aa, Aa, Ha, Ha, Ha, Ha, Ha, Ms, Ms, Ms^Xm, Ms, Ms, Ms, Ms, Ms, Ms, Ai, Ai, Ms^Xm, Ms^Xm, Ms^Xm
Xu, Xu, Xu, Xu, Xu, Xu, Xu, Xu, Xu, Ms^Xm, Ms^Xm, Ms^Xm, Ms^Xm, Ms^Xm, Ms^Xm, Ms^Xm, Ms^Xm, Ms^Xm, Ms^Xm, Ms^Xm, Ms, Ms, Ms, Ms, Ms, Ms, Ai, Ai, Ai, Ha, Ha, Ms, Ms, Ms, Ms^Xm, Ms^Xm, Ms^Xm, Ms^Xm, Ms^Xm, Ms, Ms, Ms, Ha, Ha, Aa, Aa^Fpa, Aa, Aa, Gd, Gd, Aa, Ha, Ha, Ha, Ms, Ms^Xm, Ms^Xm, Ms^Xm, Ms^Xm, Ms^Xm, Ms^Xm, Ms^Xm, Ms^Xm, Ms, Ms^Xm, Ms^Xm, Ms^Xm, Ms^Xm, Ms^Xm, Ms^Xm
Xu, Xu, Xu, Xu, Xu, Xu, Xu, Xu, Xu, Xu, Xu, Ms^Xm, Ms^Xm, Ms^Xm, Ms^Xm, Ms^Xm, Ms^Xm, Ms^Xm, Ms^Xm, Ms^Xm, Ms, Ms, Ms, Ms, Ms, Ai, Ai, Ai, Aa, Ha, Ms, Ms, Ms, Ms, Ms^Xm, Ms^Xm, Ms^Xm, Ms^Xm, Ms^Xm, Ms^Xm, Ms^Xm, Ms^Xm, Ms^Xm, Ha, Gd, Aa, Aa, Aa, Gd, Aa, Aa, Ai, Ms, Ms, Ms, Ms^Xm, Ms^Xm, Ms^Xm, Ms^Xm, Ms^Xm, Ms^Xm, Ms^Xm, Ms^Xm, Ms^Xm, Ms^Xm, Ms^Xm, Ms^Xm, Ms^Xm, Ms^Xm, Gd
