border_size=1
usage=map

Ms^Xm, Ms^Xm, Ms^Xm, Ms^Xm, Ms^Xm, Ms^Xm, Ms^Xm, Gs, Ms^Xm, Ms^Xm, Ms^Xm, Gs, Ms^Xm, Ms^Xm, Ha, Ha, Ha, Ms^Xm, Ha, Gs, Ha, Gs, Ms^Xm, Ms^Xm, Ha, Ha, Ha, Ha, Ha, Ha, Ha, Aa, Aa, Aa, Aa, Aa, Re, Re, Re, Aa, Aa, Aa, Ms, Ms^Xm, Ms^Xm, Ms^Xm
Ms^Xm, Ms^Xm, Ms^Xm, Ms^Xm, Ms^Xm, Ms^Xm, Ms^Xm, Ms^Xm, Ms^Xm, Ms^Xm, Ms^Xm, Ms^Xm, Ms^Xm, Ms^Xm, Ha, Ha, Ms^Xm, Ms^Xm, Ms^Xm, Ha, Ms^Xm, Ms^Xm, Ms^Xm, Ms^Xm, Ha, Ha, Ha, Ha, Ha, Ha, Aa, Aa, Aa, Aa, Gs, Re, Re, Re, Aa, Aa, Aa, Ms, Ms, Ms, Ms^Xm, Ms^Xm
Ms^Xm, Ms^Xm, Ms^Xm, Ms^Xm, Ms, Ms, Ms, Ms^Xm, Ms^Xm, Ms^Xm, Ms^Xm, Ms^Xm, Ms^Xm, Ms^Xm, Ms^Xm, Ms^Xm, Ha, Ms^Xm, Ms^Xm, Ms^Xm, Ms^Xm, Ms^Xm, Ms^Xm, Ms^Xm, Ha, Ha, Aa^Fpa, Aa, Aa^Fpa, Aa, Aa^Fma, Aa, Aa, Gs, Re, Re, 1 Re, Re, Re, Aa, Ms, Ms, Ms, Ms, Ms^Xm, Ms^Xm
Ms, Ms, Ms, Ms, Ms, Ms, Ms, Ms, Ms^Xm, Ms^Xm, Ms^Xm, Ms^Xm, Ms, Ms^Xm, Ms^Xm, Ms^Xm, Ms, Ms, Ms, Ms^Xm, Ms^Xm, Ms^Xm, Ms^Xm, Ms^Xm, Ha^Fma, Ha, Aa^Fma, Aa^Fpa, Aa, Aa, Aa, Aa, Gll^Fmw, Re, Re, Re, Re, Re, Aa^Fma, Aa, Ms, Ms, Ms, Ms, Ms^Xm, Ms^Xm
Ms, Ms, Ms, Ms, Ms, Ms, Ms, Ms, Ms, Ms, Ms, Ms, Ms, Ms, Ms, Ms, Ms, Ms, Ms, Ms^Xm, Ms^Xm, Ms^Xm, Ms^Xm, Ms^Xm, Ha^Fma, Ha, Aa, Aa, Aa, Aa, Gll^Fmw, Gll^Fmw, Re, Re, Re, Re, Gs, Aa, Ha^Fma, Ha^Fma, Ms, Ms, Ms, Ms^Xm, Ms^Xm, Ms^Xm
Ms, Ms, Ms, Ms, Ms, Ms, Ms, Ms, Ms, Ms, Ms, Ms, Ha, Ms, Ms, Ms, Ms, Ms, Ms^Xm, Ms^Xm, Ms^Xm, Ms^Xm, Ms^Xm, Ms^Xm, Ha, Ha, Gs, Gs, Aa, Gs, Re, Re, Re, Re, Re, Re, Ha, Ha, Aa^Fma, Aa, Aa^Fma, Aa, Ms, Ms^Xm, Ms^Xm, Ms^Xm
Ms, Ms, Ms, Ms, Ms, Ms, Ms, Ms, Ms^Xm, Ms, Ms, Ha, Ha^Fma, Ha^Fma, Ms, Ms, Ms, Ms, Ha, Ms^Xm, Ms, Ms^Xm, Ha, Ha, Ha, Gs, Gs, Aa, Gs, Re, Aa, Aa, Re, Re, Gll^Fmw, Gs, Aa, Ms, Ms, Aa^Fma, Aa, Aa, Ms, Ms, Aa^Fma, Ms^Xm
Ms, Ms, Ms^Xm, Ms, Ms, Ms, Ms^Xm, Ms^Xm, Ms^Xm, Ms^Xm, Ms^Xm, Ha, Ha, Ha, Ms, Ms, Ha^Fma, Ha, Ha^Fma, Ha, Ms, Ms, Ha, Ha^Fma, Gs, Gs, Gs, Gs, Gs, Re, Re, Re, Gll^Fmw, Gll^Fmw, Gs, Gs, Ha, Ha, Ms, Ms, Ms, Ms, Ms, Ms, Ms^Xm, Aa
Ha, Ms^Xm, Ms^Xm, Ms^Xm, Ms^Xm, Ms^Xm, Ms^Xm, Ms^Xm, Ms^Xm, Ms^Xm, Ha, Ms^Xm, Ms, Ms, Ms, Ha, Ha^Fma, Ha^Fma, Ha, Ha, Ms, Ms, Ha, Ha^Fma, Aa^Fma, Aa, Gs, Gs, Re, Re, Re, Re, Gs, Gll^Fmw, Gs, Ha, Ms, Ms, Ms, Ms, Ms, Ms, Ms^Xm, Ms^Xm, Ms^Xm, Ms^Xm
Ha, Ha, Ms^Xm, Ms^Xm, Ms^Xm, Ms^Xm, Ms^Xm, Ms^Xm, Ha^Fpa, Ha, Ha^Fpa, Ha^Fpa, Ms, Ms, Ms, Ha, Ha, Ha, Ms^Xm, Ms, Ms, Ha, Ha, Aa^Fma, Gll^Fmw, Gll^Fp, Aa, Aa, Re, Re, Re, Re, Aa, Aa, Ha, Ha, Ms, Ms, Ms, Ms, Ms, Ms, Ms^Xm, Ms^Xm, Ms^Xm, Ms^Xm
Ha, Ha, Ms, Ms^Xm, Ha, Ms^Xm, Ha, Ha^Fpa, Ha^Fpa, Ha^Fpa, Ha, Ha^Fpa, Ms, Ms, Ms, Ms, Ms^Xm, Ms^Xm, Ms^Xm, Ms^Xm, Ha, Ha, Ha, Gll^Fmw, Aa, Gll^Fp, Aa, Re, Re, Re, Re, Gs, Gs, Gs, Ha, Ms, Ms, Ms, Ms, Ms, Ms, Ms, Ms^Xm, Ms^Xm, Ms^Xm, Ms^Xm
Ms, Ms, Ha, Ha^Fpa, Ha^Fpa, Ha^Fma, Ha^Fma, Ha^Fpa, Ha, Ha, Ms^Xm, Ms, Ms, Ms, Ms, Ms, Ms^Xm, Ms^Xm, Ms, Ms, Ha, Ha, Aa^Fpa, Aa, Gs, Aa, Re, Re, Re, Re, Gs, Aa, Aa, Aa, Ha, Ms, Ms, Ms, Ms, Ms, Ms, Ms^Xm, Ms^Xm, Ms^Xm, Ms^Xm, Ms^Xm
Ms, Ms, Ha, Ha^Fpa, Ha, Ha^Fpa, Ha^Fpa, Ha, Ha, Ms^Xm, Ms^Xm, Ms, Ms, Ms, Ha^Fpa, Ha^Fpa, Ha^Fpa, Ms, Ms, Ms, Ms, Ha, Gll^Fp, Gll^Fp, Gs, Re, Re, Re, Re, Re, Aa, Aa, Aa, Ha, Ms, Ms, Ms, Ms, Ms, Ms, Ms, Ms^Xm, Ms^Xm, Ms^Xm, Ms^Xm, Ms^Xm
Ms, Ms, Ms, Ha, Ms^Xm, Ha, Ms^Xm, Ha, Ms^Xm, Ms^Xm, Ms^Xm, Ms^Xm, Ha, Ha, Aa, Aa^Fpa, Ha, Ms, Ms, Ms, Ha, Ha, Gll^Fp, Gll^Fp, Aa, Re, Aa, Re, Gs, Gs, Gll^Fp, Gs, Ha, Ms, Ms, Ms, Ms, Ms, Ms, Ms, Ms, Ms, Ms, Ms^Xm, Ha, Ha
Ms, Ms, Ms, Ms, Ms^Xm, Ms^Xm, Ms^Xm, Ms^Xm, Ms^Xm, Ms^Xm, Ms, Ms, Ha, Aa^Fma, Ha^Fma, Ha, Ms, Ms, Ms, Ha, Aa, Gs, Gs, Gs, Re, Aa, Re, Re, Gll^Fmw, Gll^Fp, Ha, Ha^Fma, Ms, Ms, Ms, Ms, Ms, Ms, Ms, Ms, Ms, Ms, Ms, Ha, Ms^Xm, Ms^Xm
Ms^Xm, Ms^Xm, Ms^Xm, Ms^Xm, Ms, Ms^Xm, Ms, Ms^Xm, Ms^Xm, Ms^Xm, Ms, Ms, Ms, Aa, Aa^Fma, Ms, Ha, Ms, Ha, Aa, Gs, Aa, Re, Re, Re, Re, Re, Re, Gll^Fmw, Gll^Fmw, Ha^Fpa, Ms, Ms, Ms, Ms, Ms, Ms, Ms, Ms^Xm, Ms, Ms, Ms, Ms, Ha, Ms^Xm, Ms^Xm
Ms^Xm, Ms^Xm, Ms^Xm, Ms, Ms, Ms, Ms, Ms, Ms, Ms^Xm, Ms, Ms, Ms, Ha, Aa^Fma, Ha, Ha, Aa, Aa, Aa, Gs, Aa, Re, Re, Aa, Re, Aa, Gll^Fmw, Gs, Ha, Ha^Fma, Ha, Ms, Ms, Ms, Ms, Ms^Xm, Ms^Xm, Ms^Xm, Ms^Xm, Ms, Ms, Ms, Ms^Xm, Ms^Xm, Ms^Xm
Ms^Xm, Ms^Xm, Ms, Ms, Ms, Ms, Ms, Ms, Ms, Ms, Ms, Ms, Ha^Fma, Ha, Ha, Ha^Fma, Gll^Fp, Gs^Vea, Re, Re, Re, Re, Re, Re, Aa, Aa, Gs, Gll^Fp, Gll^Fp, Ha^Fma, Ha, Ha, Ms^Xm, Ms, Ms, Ms, Ms^Xm, Ms^Xm, Ms^Xm, Ms^Xm, Ms, Ms, Ms, Ms^Xm, Ms^Xm, Ms^Xm
Ms, Ms, Ms, Ms, Ms, Ms, Ms, Ms, Ms^Xm, Ms, Ms, Ha, Ha, Ha, Gll^Fp, Gll^Fp, Aa, Gll^Fp, Re, Re, Re, Re, Aa, Re, Gs, Gs, Gs, Gs, Ms, Ha, Ha, Ms^Xm, Ms^Xm, Ms^Xm, Ms^Xm, Aa, Ms^Xm, Ms^Xm, Ms^Xm, Ms^Xm, Ms, Ms, Ms, Ms, Ms, Aa
Ms, Ms, Ms, Ms, Ms, Ms, Ms^Xm, Ms^Xm, Ms^Xm, Ms^Xm, Ha^Fpa, Ms, Ha, Gs, Gll^Fmw, Aa, Gs, Re, Re, Re, Re, Aa, Aa, Aa, Gs, Gs, Ha, Ms, Ms, Ms, Ms, Ms^Xm, Ms^Xm, Ms^Xm, Ms^Xm, Ms^Xm, Ms^Xm, Ms^Xm, Ms^Xm, Ms^Xm, Ms, Ms, Ms, Ms, Ms, Aa
Ms, Ms, Ms, Ms, Ms^Xm, Ms^Xm, Ms^Xm, Ms^Xm, Ms^Xm, Ms^Xm, Ha, Ha^Fpa, Ha^Fma, Gll^Fmw, Gll^Fmw, Aa, Aa, Re, Re, Re, Aa, Aa^Fma, Ha^Fma, Ha^Fma, Ha, Ha, Ha, Ms, Ms, Ms, Ms, Ms, Ms, Ms^Xm, Ms^Xm, Ms^Xm, Ms, Ms, Ms, Ms, Ms, Ms, Ms, Ms, Ms^Xm, Ms^Xm
Ms, Ms, Ms, Ms^Xm, Ms^Xm, Ms^Xm, Ms^Xm, Ms^Xm, Ms, Ha^Fma, Ha^Fpa, Ha^Fma, Gs, Gll^Fmw, Re, Aa, Aa, Aa, Re, Re, Ha, Ha^Fma, Ms, Ms, Ms, Ms, Ms, Ms, Ms, Ms, Ms, Ms, Ms, Ms, Ms, Ms, Ms, Ms, Ms, Ms, Ms, Ms, Ms, Ms, Ms, Ms^Xm
Ms, Ms, Ms^Xm, Ms^Xm, Ms, Ms, Ms, Ms, Ms, Aa, Ms, Ha, Gs, Gs, Re, Re, Re, Re, Gs, Gs, Aa, Ms, Ms, Ms, Ms, Ms, Ms, Ms, Ms, Ms^Xm, Ms^Xm, Ms, Ms, Ms, Ms, Ms, Ms, Ms, Ms, Ms, Ms, Ms, Ms, Ms, Ms, Ms^Xm
Ms^Xm, Ms^Xm, Ms^Xm, Ms^Xm, Ms, Ms, Ms, Ms, Ms, Ha, Ms, Ha, Gs, Gs, Aa, Re, Re, Gs, Gll^Fmw, Aa^Fma, Aa, Ms, Ms, Ms, Ms, Ms, Ms, Ms, Ms^Xm, Ms^Xm, Ms^Xm, Ms, Ms, Ms, Ms, Ms, Ms, Ms, Ms, Ms, Ms^Xm, Ms, Ms, Ms, Ms^Xm, Ms^Xm
Ms^Xm, Ms^Xm, Ms^Xm, Ms, Ms, Ms, Ms, Ms, Ms, Ha, Aa, Ha^Fpa, Aa^Fpa, Gs, Aa, Aa, Re, Re, Gll^Fmw, Aa^Fma, Aa^Fpa, Ms, Ms, Ms, Ms, Ms^Xm, Ms^Xm, Ms^Xm, Ms^Xm, Ms^Xm, Ms^Xm, Ms^Xm, Ms, Ms, Ms, Ms, Ms, Ms, Ms, Ms, Ms^Xm, Ms, Ms, Ms, Ms, Ms^Xm
Ms^Xm, Ms^Xm, Ms, Ms, Aa^Fpa, Aa^Fpa, Ms, Ms, Ms^Xm, Aa, Ha, Aa^Fpa, Ha^Fpa, Gll^Fp, Gll^Fp, Aa, Re, Re, Gs, Gs^Fpa, Gs^Fpa, Aa, Ha, Ms, Ms, Ms, Ms, Ms^Xm, Ms, Ms^Xm, Ms^Xm, Ms, Ms, Ms, Ms, Ms, Ms^Xm, Ms, Ms^Xm, Ms^Xm, Ms^Xm, Ms, Ms, Ms, Ms, Ms
Ms^Xm, Ms^Xm, Ms, Ms, Ms, Aa^Fpa, Ms, Ms, Ms^Xm, Ms^Xm, Ms^Xm, Ha, Ha, Gll^Fp, Gll^Fp, Re, Re, Re, Re, Gs, Gs, Ha^Vea, Ha^Fpa, Ms, Ms, Ms, Ha, Ms, Ms, Ha, Ha, Ms, Ms, Ms, Ha, Ms^Xm, Ms^Xm, Ms^Xm, Ms^Xm, Ms^Xm, Ms^Xm, Ms^Xm, Ms^Xm, Ms, Ms, Ms
Ms^Xm, Ms^Xm, Ms^Xm, Ms, Ms, Ms, Ms, Ms, Ms^Xm, Ms^Xm, Ms^Xm, Ms^Xm, Aa, Gs, Aa, Re, Re, Re, Re, Re, Re, Gs, Gs, Ha, Ms, Ha, Ha, Ha, Ha, Ha, Ha^Fpa, Ha^Fpa, Aa, Ha^Fpa, Ha^Fpa, Ha, Ms^Xm, Ms^Xm, Ms^Xm, Ms^Xm, Ms^Xm, Ms^Xm, Ms^Xm, Ms, Ms, Ms
Ms, Ms^Xm, Ms^Xm, Ms^Xm, Ms^Xm, Ms, Ms, Ms, Ha, Ms^Xm, Ha, Aa, Aa, Gll^Fp, Gs, Aa, Gs, Re, Re, Re, Re, Re, Re, Gs, Gs, Aa, Gs, Aa, Aa, Aa^Fpa, Aa, Aa, Ha, Aa^Fpa, Ha^Fpa, Ms^Xm, Ms^Xm, Ms^Xm, Ha, Ms^Xm, Ms, Ms^Xm, Ms^Xm, Ms^Xm, Ms, Ms
Ms, Ms, Ms^Xm, Ms^Xm, Ms^Xm, Ms^Xm, Ms^Xm, Ha, Ha^Fma, Ha^Fma, Ha^Fma, Ha^Fma, Ha, Aa, Aa, Aa, Gs, Gs, Aa, Re, Re, Re, Re, Re, Aa, Re, Aa, Gs, Re, Gs, Re, Gs, Re, Aa, Aa, Ha^Fpa, Ha, Ha, Ha, Ms, Ms, Ms, Ms, Ms, Ms, Ms
Ms, Ms, Ms^Xm, Ms^Xm, Ms^Xm, Ms^Xm, Ms^Xm, Ms^Xm, Ms^Xm, Ha^Fma, Ha, Ha, Ms, Ha, Ha, Ha^Fma, Ha^Fma, Aa, Gll^Fp, Re, Re, Re, Re, Re, Re, Aa, Re, Re, Re, Re, Re, Re, Re, Re, Re, Aa^Vea, Aa, Aa^Fma, Aa, Ms, Ms, Ms, Ms, Ms, Ms, Ms
Ms, Ms, Ms, Ms^Xm, Ms^Xm, Ms^Xm, Ms, Ms^Xm, Ms^Xm, Ha, Ms, Ms, Ms, Ms, Ms, Ha^Fma, Ha, Ha, Aa, Gs, Aa, Gs, Aa, Re, Aa, Re, Re, Re, Re, Re, Re, Re, Re, Re, Re, Re, Re, Gs^Fma, Gs^Fma, Ha^Fma, Ha^Fma, Ms, Ms, Ms, Ms^Xm, Ms
Ms, Ms, Ms, Ms, Ms, Ms, Ms, Ms, Ms^Xm, Ms^Xm, Ms^Xm, Ms, Ms, Ms, Ms, Ms, Ms, Ha, Ha, Aa, Aa, Aa, Ha, Aa, Aa, Aa, Aa, Gs, Gs, Re, Gs, Re, Gs, Re, Re, Re, Re, Re, Gs, Aa, Aa, Ha, Ha, Ms^Xm, Ms^Xm, Ms^Xm
Ms^Xm, Ms, Ms, Ms, Ms, Ms, Ms, Ms, Ms^Xm, Ms^Xm, Ms^Xm, Ms^Xm, Ms^Xm, Ms, Ms, Ms, Ms, Ms, Ms, Ha^Fma, Aa^Fma, Ha^Vea, Ms, Ms, Ha, Ha, Ha^Fpa, Gll^Fp, Ha, Ms, Ms, Aa, Aa, Gs, Gll^Fmw, Re, Re, Re, Re, Gs, Aa, Ha, Ms, Ms, Ms, Ms^Xm
Ms^Xm, Ms^Xm, Ms^Xm, Ms, Ms, Ms^Xm, Ms^Xm, Ms^Xm, Ms^Xm, Ms^Xm, Ms^Xm, Ms^Xm, Ms^Xm, Ms^Xm, Ms^Xm, Ms, Ms, Ms, Ms, Aa, Aa, Ha, Ms, Ms, Ha, Ms, Ha, Ha^Fpa, Ha, Ms, Ms, Ms, Ms, Aa, Aa, Re, Re, Re, Re, Gs, Aa, Aa, Ms, Ms, Ms, Ms^Xm
Ms^Xm, Ms^Xm, Ms^Xm, Ms, Ms, Ms, Ms^Xm, Ms^Xm, Ms^Xm, Ms^Xm, Ms, Ms^Xm, Ms^Xm, Ms^Xm, Ms^Xm, Ms^Xm, Ms^Xm, Ms, Ha^Fpa, Ms, Ha, Ha, Ms, Ms, Ha^Fpa, Ha, Ms^Xm, Ha, Ms, Ms, Ms, Ms, Ms, Aa, Aa, Gs, Re, Re, Re, Re, Re, Ha, Ha^Fma, Ms, Ms^Xm, Ms^Xm
Ms^Xm, Ms^Xm, Ms^Xm, Ms, Ms, Ms, Ms^Xm, Ms^Xm, Ms, Ms, Ms, Ms, Ms, Ms, Ms, Ms^Xm, Ms, Ha^Fpa, Ha, Ha, Ha, Ha, Ms, Ha, Ms, Ha, Ms^Xm, Ms^Xm, Ms^Xm, Ms^Xm, Ms, Ms, Ms, Ms, Ha^Fma, Aa, Gll^Fmw, Re, Re, Re, Re, Aa, Aa, Ms, Ms^Xm, Ms^Xm
Ms^Xm, Ms^Xm, Ms^Xm, Ms, Ms, Ms, Ms^Xm, Ms^Xm, Ms, Ms, Ms, Ms, Ms, Ms, Ms, Ms, Ms, Ms, Ms, Ms, Ms, Ms, Ms, Ha, Ha, Ms, Ms^Xm, Ms^Xm, Ms^Xm, Ms^Xm, Ms^Xm, Ms, Ms, Ms, Ha^Fma, Aa, Aa, Gs, Re, Re, Re, Aa, Aa, Ms, Ms, Ms^Xm
Ms, Ms^Xm, Ms^Xm, Ms, Ms, Ms, Ms^Xm, Ms^Xm, Ms, Ms, Ms, Ms, Ms, Ms, Ms^Xm, Ms, Ms, Ms, Ms, Ms, Ms, Ms, Ms, Ha^Fpa, Aa^Fpa, Ms^Xm, Ms^Xm, Ms^Xm, Ms^Xm, Ms^Xm, Ms^Xm, Ms^Xm, Ms, Ms, Ha^Fma, Ha^Fma, Aa, Gs, Re, Re, Re, Ha, Ha^Fpa, Ms, Ms, Ms
Ms, Ms, Ms^Xm, Ms^Xm, Ms^Xm, Ms^Xm, Ms^Xm, Ms^Xm, Ms, Ms, Ms, Ms, Ms^Xm, Ms^Xm, Ms^Xm, Ms^Xm, Ha, Ms, Aa, Ms, Ha, Ha, Ha, Ha, Aa^Fpa, Aa^Fpa, Aa, Aa, Ms, Ms, Ms, Ms, Ms, Ms, Ms, Ha, Aa, Re, Re, Re, Re, Ha^Fpa, Ha^Fpa, Ms, Ms, Ms
Ms, Ms, Ms, Ms^Xm, Ms^Xm, Ms^Xm, Ms, Ms, Ms, Ms, Ms^Xm, Ms^Xm, Ms, Ms, Ms, Ha^Fpa, Aa^Fpa, Aa, Aa, Ha, Gs, Ha^Fpa, Aa, Ha, Gll^Fp, Aa, Ha^Fpa, Ha^Fpa, Ms, Ms, Ms, Ms, Ms, Ms, Ha, Ha, Aa^Vea, Re, Re, Re, Gs, Aa, Aa, Ha^Fpa, Ms^Xm, Ms^Xm
Ms, Ms, Ms, Ms, Ms, Ms, Ms, Ms, Ms, Ms^Xm, Ms^Xm, Ms, Ms, Ms, Ms, Ha^Fpa, Ha^Fpa, Ha, Gs, Aa^Vea, Re, Aa, Re, Aa, Re, Gll^Fp, Gs, Ha^Fpa, Ha, Ha, Aa, Ha, Ha, Ha, Ha, Gs, Re, Re, Re, Re, Ha, Aa, Aa, Ha, Ms^Xm, Ms^Xm
Ms, Ms, Ms, Ms, Ms, Ms, Ms, Ms, Ms, Ms^Xm, Ms, Ms, Ms, Ms, Ms, Ha, Aa^Fpa, Gll^Fp, Re, Re, Re, Re, Re, Re, Re, Re, Re, Gs, Aa, Aa, Aa, Aa, Aa, Aa, Gll^Fp, Gs, Re, Re, Re, Gll^Fp, Aa, Aa, Ha, Ms, Ms^Xm, Ms^Xm
Ms, Ms, Ms, Ms, Ms, Ms, Ms, Ms, Ms, Ms, Ms, Ms, Ms, Ms, Ha^Fpa, Aa^Fpa, Gs, Re, Re, Re, Re, Re, Re, Re, Re, Re, Re, Re, Re, Re, Re, Gs, Gs, Gs, Re, Re, Re, Re, Re, Aa^Fpa, Ha^Fpa, Ha^Fpa, Ms, Ms, Ms, Ms^Xm
Ms, Ms, Ms, Ms, Ms, Ms, Ms, Ms, Ms, Ha^Fpa, Ha, Ms, Ha, Ha^Fpa, Gs, Aa, Re, Re, Re, Re, Gs, Re, Gs, Re, Gs, Re, Re, Re, Re, Re, Re, Re, Re, Re, Re, Re, Re, Re, Ha, Ha, Ha, Ms, Ms, Ms, Ms, Ms^Xm
Ms, Ms, Ms, Ms, Ms, Ms, Ms, Ms, Ms^Xm, Ha, Ms, Ha^Fpa, Ha^Fpa, Ha^Fpa, Gs, Gs, Re, Re, Re, Re, Gs, Gs, Ms, Gs, Gs^Fpa, Gll^Fp, Gs^Fpa, Re, Re, Re, Re, Re, Re, Re, Re, Re, Ha^Fpa, Ha, Ha, Ms, Ms, Ms, Ms^Xm, Ms^Xm, Ms^Xm, Ms^Xm
Ms, Ms, Ms, Ms, Ms, Ms, Ms, Ms^Xm, Ms^Xm, Ms, Ms, Ms, Ha, Gs, Aa^Fma, Re, Re, Re, Re, Gs, Gll^Fp, Gll^Fp, Ha^Fpa, Ha^Fpa, Ha, Aa^Fpa, Ha^Fpa, Gll^Fp, Gll^Fp, Re, Re, Re, Re, Re, Gs, Ha^Fpa, Ha^Fpa, Ms, Ms, Ms, Ms^Xm, Ms^Xm, Ms^Xm, Ms^Xm, Ms^Xm, Ms^Xm
Ms, Ms, Ms, Ms, Ms^Xm, Ms, Ms, Ms, Ms, Ms, Ms, Ms, Ha, Aa^Fma, Re^Fma, Re, Re, Re, Gs, Gs, Aa, Ha, Ha, Ha, Ms, Aa, Aa, Ha^Fpa, Ha, Ha^Vea, Ha, Gll^Fmw, Gll^Fmw, Aa, Aa, Ha, Ms, Ms, Ms, Ms^Xm, Ms^Xm, Ms^Xm, Ms^Xm, Ms^Xm, Ms^Xm, Aa
Ms^Xm, Ms^Xm, Ms^Xm, Ms^Xm, Ms^Xm, Ms^Xm, Ms, Ms, Ms, Ms, Ms, Ms, Aa, Aa^Fma, Re, Re, Re, Re, Gs, Aa, Aa, Ha, Ms, Ms, Ms^Xm, Ms, Ms, Ms, Ms, Ha, Ms, Ha, Ms, Aa, Aa, Ms, Ms, Ms, Ms^Xm, Ms^Xm, Ms^Xm, Ms^Xm, Ms^Xm, Ms^Xm, Ms, Aa
Ms, Ms^Xm, Ms^Xm, Ms^Xm, Ms^Xm, Ms^Xm, Ms, Ms, Ms, Ms, Ms, Ms, Aa, Aa^Vea, Re, Re, Re, Gs, Gll^Fp, Aa, Aa, Ha, Ms, Ms^Xm, Ms^Xm, Ms, Ms^Xm, Ms^Xm, Ms^Xm, Ms^Xm, Ms^Xm, Ms, Ms^Xm, Ms, Ms^Xm, Ms, Ms^Xm, Ms^Xm, Ms^Xm, Ms^Xm, Ms^Xm, Ms^Xm, Ms^Xm, Ms, Ms^Xm, Aa
Ms, Ms, Ms^Xm, Ms^Xm, Ms, Ms, Ms, Ms, Ha, Ms, Ha^Fma, Aa, Ha^Fpa, Gs, Re, Re, Re, Gs, Gs, Gll^Fp, Aa, Ha, Ms, Ms^Xm, Ms^Xm, Ms, Ha, Ha, Ms^Xm, Ms^Xm, Ms^Xm, Ms^Xm, Ms^Xm, Ms^Xm, Ms^Xm, Ms^Xm, Ms^Xm, Ms^Xm, Ms, Ms^Xm, Ms^Xm, Ms^Xm, Ms^Xm, Ms^Xm, Ms^Xm, Aa
Ms, Ms, Ms^Xm, Ms^Xm, Ms, Ms, Ms, Ms, Ms^Xm, Ha, Ha^Fma, Ha^Fma, Ha^Fma, Gll^Fp, Re, Re, Re, Gs, Gs, Aa, Ha^Fma, Aa, Ms, Ms, Ms, Ha, Ha, Ha, Ms^Xm, Ms^Xm, Ms^Xm, Ms^Xm, Ms^Xm, Ms^Xm, Ms^Xm, Ms, Ms, Ms, Ms, Ms, Ms^Xm, Ms^Xm, Ms^Xm, Ms^Xm, Ms^Xm, Ms^Xm
Ms, Ms, Ms, Ms^Xm, Ms^Xm, Ms, Ms^Xm, Ms^Xm, Ms^Xm, Ms^Xm, Aa, Ha, Aa, Aa, Gll^Fp, Re, Re, Re, Re, Gs, Gs, Ha^Fma, Ha, Ha^Fpa, Ha^Fpa, Ha^Fpa, Ms, Ms^Xm, Ms, Ms^Xm, Ms, Ms^Xm, Ms^Xm, Ms^Xm, Ms^Xm, Ms, Ms, Ms, Ms, Ms, Ms^Xm, Ms^Xm, Ms^Xm, Ms^Xm, Ms^Xm, Ms^Xm
Ms, Ms, Ms, Ms, Ms, Ms, Ms, Ms^Xm, Ha, Ms^Xm, Ha, Aa, Ha^Fpa, Aa, Gll^Fp, Re, Re, Re, Re, Re, Re, Gll^Fp, Gll^Fp, Aa^Fma, Aa^Fma, Ms, Ha^Fpa, Ha, Ha^Fma, Ha^Fma, Ha^Fma, Ms^Xm, Ms^Xm, Ms^Xm, Ms^Xm, Ms, Ms, Ms, Ms, Ms, Ms^Xm, Ms^Xm, Ms^Xm, Ms^Xm, Ms^Xm, Ms^Xm
Ms, Ms, Ms, Ms, Ms, Ms, Ha, Ha, Ms^Xm, Ha, Ms^Xm, Ha, Ha, Aa, Gll^Fmw, Gll^Fp, Re, Re, Re, Re, Re, Re, Re, Gll^Fp, Aa^Fma, Aa^Fma, Ha^Fpa, Ms, Ms, Ha^Fma, Ha, Ms, Ms, Ms^Xm, Ms^Xm, Ms^Xm, Ms^Xm, Ms^Xm, Ms^Xm, Ms^Xm, Ms^Xm, Ms^Xm, Ms^Xm, Ms^Xm, Ms^Xm, Ms^Xm
Ms, Ms, Ms, Ms, Ms, Ms, Ha, Ha, Ms^Xm, Ms^Xm, Ms^Xm, Ms^Xm, Ms^Xm, Ha, Ha, Gll^Fmw, Gs, Re, Re, Re, Re, Aa, Aa, Gll^Fp, Aa^Vea, Ha^Fpa, Ms, Ms, Ms, Ha, Ms, Ha, Ms, Ms, Ms^Xm, Ms^Xm, Ms^Xm, Ms^Xm, Ms^Xm, Ms^Xm, Ms^Xm, Ms^Xm, Ms^Xm, Ms^Xm, Ms^Xm, Ms^Xm
Ms, Ms, Ms, Ms, Ms, Ha, Ms, Ms^Xm, Ms^Xm, Ms^Xm, Ms^Xm, Ms^Xm, Ms^Xm, Ms^Xm, Ha, Ha, Ha, Ha^Fpa, Aa, Gs, Re, Re, Aa, Gs, Gll^Fp, Ha, Ha, Ms, Ms, Ms, Ms, Ms, Ms, Ms, Ms^Xm, Ms^Xm, Ms^Xm, Ms^Xm, Ms^Xm, Ms^Xm, Ms^Xm, Ms^Xm, Ms^Xm, Ms^Xm, Ms^Xm, Ms^Xm
Ms, Ms, Ms, Ms, Ms, Ms, Ms, Ms^Xm, Ms^Xm, Ms^Xm, Ms^Xm, Ms^Xm, Ms^Xm, Ms^Xm, Ms^Xm, Ms^Xm, Ms^Xm, Ha, Ha, Gll^Fmw, Re, Re, Re, Gs, Gll^Fp, Aa, Ha, Ms, Ms, Ms, Ms^Xm, Ms^Xm, Ms^Xm, Ms^Xm, Ms^Xm, Ms^Xm, Ms^Xm, Ms^Xm, Ms^Xm, Ms^Xm, Ms^Xm, Ms^Xm, Ms^Xm, Ms^Xm, Ms^Xm, Ms^Xm
Ms, Ms, Ms, Ms, Ms, Ms, Ms, Ms, Ha^Fpa, Ms^Xm, Ms^Xm, Ms^Xm, Aa^Fpa, Ms^Xm, Ms^Xm, Ms^Xm, Ms^Xm, Ms^Xm, Aa, Gs, Re, Re, Re, Gs, Gll^Fp, Aa, Ha^Fpa, Ms, Ms, Ms^Xm, Ms^Xm, Ms^Xm, Ms^Xm, Ms^Xm, Ms^Xm, Ms^Xm, Ms^Xm, Ms^Xm, Ms^Xm, Ms^Xm, Ms^Xm, Ms^Xm, Ms^Xm, Ms^Xm, Ms^Xm, Ms^Xm
Ms, Ms, Ms^Xm, Ms, Ms, Ms, Ms, Ms, Ha, Ha^Fpa, Ha^Fpa, Aa^Fpa, Aa^Fpa, Aa, Ha, Ha, Gll^Fp, Gll^Fp, Re, Re, Re, Re, Gs, Gs, Aa, Ha^Fpa, Ha^Fpa, Ms, Ms, Ms^Xm, Ms^Xm, Ms^Xm, Ms^Xm, Ms^Xm, Ms^Xm, Ms^Xm, Ms^Xm, Ms^Xm, Ms^Xm, Ms^Xm, Ms^Xm, Ms^Xm, Ms^Xm, Ms^Xm, Ms^Xm, Ms^Xm
Ms^Xm, Ms^Xm, Ms^Xm, Ms^Xm, Ms, Ms, Ms, Ms, Ms, Ms, Ms, Ha, Aa^Fpa, Ha^Fpa, Aa^Vea, Aa, Gll^Fp, Re, Re, Re, Re, Gs, Gs, Gll^Fp, Aa, Ha, Ms, Ms, Ms, Ms, Ms, Ms^Xm, Ms^Xm, Ms^Xm, Ms, Ms^Xm, Ms^Xm, Ms^Xm, Ms^Xm, Ms^Xm, Ms^Xm, Ms^Xm, Ms^Xm, Ms^Xm, Ms^Xm, Ms^Xm
Ms^Xm, Ms^Xm, Ms^Xm, Ms^Xm, Ms, Ms, Ms, Ms, Ms, Ms, Ms^Xm, Ms, Ms, Ha^Fpa, Ms, Aa, Gll^Fp, Re, Re, Re, Gs, Gs, Gll^Fp, Ms, Ms, Ms, Ms, Ms, Ms, Ms, Ms, Ms^Xm, Ms^Xm, Ms^Xm, Ms^Xm, Ms^Xm, Ms^Xm, Ms^Xm, Ms^Xm, Ms^Xm, Ms^Xm, Ms^Xm, Ms^Xm, Ms^Xm, Ms^Xm, Ms^Xm
Ms^Xm, Ms^Xm, Ms^Xm, Ms^Xm, Ms^Xm, Ms, Ms, Ms, Ms^Xm, Ms^Xm, Ms^Xm, Ms^Xm, Ms^Xm, Ms, Ms, Gll^Fp, Re, Re, Re, Re, Gs, Gs, Ha, Ha, Ha, Ha^Fpa, Ha^Fpa, Ha, Ms, Ms, Ms, Ms^Xm, Ms^Xm, Ms^Xm, Ms^Xm, Ms^Xm, Ms^Xm, Ms^Xm, Ms^Xm, Ms^Xm, Ms^Xm, Ms^Xm, Ms^Xm, Ms^Xm, Ms^Xm, Ms
Ms, Ms^Xm, Ms^Xm, Ms^Xm, Ms^Xm, Ms^Xm, Ms^Xm, Ms^Xm, Ms^Xm, Ms^Xm, Ms^Xm, Ms^Xm, Ms, Ms, Ms, Gll^Fp, Cv, Re, Re, Re, Gs, Gs, Gll^Fp, Ha, Ha, Ha^Fpa, Ha^Fpa, Ms, Ms, Ms, Ha, Ms^Xm, Ms^Xm, Ms^Xm, Ms^Xm, Ms^Xm, Ms, Ms^Xm, Ms, Ms, Ms^Xm, Ms^Xm, Ms^Xm, Ms^Xm, Ms^Xm, Gs
Ms, Ms, Ms^Xm, Ms^Xm, Ms^Xm, Ms^Xm, Ms^Xm, Ms^Xm, Ms, Ha, Ha, Ms, Ha, Ha, Ms, Ms, Gll^Fp, Re, Re, Re, Re, Cv, Gll^Fp, Aa, Ha, Ha, Ha^Fpa, Ms, Ms, Ms, Ms, Ms, Ms^Xm, Ms^Xm, Ms^Xm, Ms^Xm, Ms, Ms, Ms, Ms^Xm, Ms^Xm, Ms^Xm, Ms^Xm, Ms^Xm, Ms^Xm, Ms
Ms, Ms, Ms, Ms^Xm, Ms, Ms^Xm, Ms^Xm, Ms^Xm, Ms, Ms, Ms, Ms, Ms, Ms, Ms, Ha, Cv, Re, Re, Re, Re, Cv, Gs^Vea, Aa, Aa, Ha, Aa^Fpa, Ha, Ha, Ms^Xm, Ms^Xm, Ms^Xm, Ms^Xm, Ms^Xm, Ms^Xm, Ms^Xm, Aa^Fma, Ms, Ms, Ms^Xm, Ms^Xm, Ms^Xm, Ms^Xm, Ms^Xm, Ms^Xm, Ms
Ha, Ha, Aa^Fpa, Ms, Ms, Ms, Ms, Ms, Ms, Ms, Ms, Ms, Ms, Ha, Ha, Cv, Gs^Fpa, Re, Re, Re, Re, Re, Re, Aa, Aa, Aa^Fpa, Aa^Fpa, Ha^Fpa, Ha, Ha, Ms^Xm, Ms^Xm, Ms^Xm, Ms^Xm, Ms^Xm, Ms^Xm, Aa^Fma, Aa^Fma, Ms^Xm, Ms^Xm, Ms^Xm, Ms^Xm, Ms^Xm, Ms^Xm, Ms^Xm, Ms
Ha, Ms, Aa^Fpa, Ms, Ms, Ms, Ms, Ms, Ms, Ms, Ms, Ms, Ha, Ha, Gs, Gs^Fpa, Aa, Gs, Gs, Re, Re, Re, Re, Re, Aa, Aa^Fpa, Ha, Ha, Ms, Ms, Ms^Xm, Ms^Xm, Ms^Xm, Ms^Xm, Ms^Xm, Ms^Xm, Ms^Xm, Ms^Xm, Ms, Ms, Ms, Ms^Xm, Ms^Xm, Ms^Xm, Ms^Xm, Ms^Xm
Ha, Aa^Fpa, Aa^Fpa, Ms, Ha, Ha, Ha, Ha, Aa, Ms, Ha, Ha, Gs^Fma, Aa^Fma, Gll^Fp, Aa^Fpa, Gs, Aa, Aa, Gs, Re, Re, Re, Re, Gs, Aa, Ha^Fma, Ha, Aa^Fma, Ms, Ms, Ha, Ha, Ms^Xm, Ms^Xm, Ms^Xm, Ms, Ms, Ms, Ms, Ms, Ms^Xm, Ms, Ms^Xm, Ms^Xm, Ms^Xm
Ha, Ha, Ha^Fpa, Ha^Fpa, Ha^Fma, Ha^Fma, Ha^Fma, Ha, Ha, Ha, Aa, Gs, Aa^Fma, Gs^Fma, Gll^Fp, Gll^Fp, Aa^Fma, Gs, Aa, Gll^Fmw, Gs, Re, Re, Re, Re, Aa, Aa^Fma, Ha, Ha^Fma, Aa^Fma, Ha, Ha^Fpa, Ha^Fpa, Ha, Ha^Fpa, Ha, Ha^Fma, Ms, Ha, Ms, Ms, Ms, Ms, Ms^Xm, Ms^Xm, Ms^Xm
Ha, Aa, Ha, Ha^Fma, Ha^Fma, Aa^Fma, Aa^Fma, Aa^Fma, Aa^Fpa, Aa^Fpa, Aa^Fpa, Aa^Fma, Aa^Fma, Aa^Fma, Aa^Fma, Gll^Fp, Gll^Fp, Aa^Vea, Aa, Aa^Fma, Gs, Re, Re, Re, Re, Re, Re, Cv, Cv, Ha, Aa^Fma, Ha, Aa^Fma, Ha^Fpa, Aa^Vea, Aa^Fma, Aa^Fma, Ha, Ha, Ms, Ms, Ms, Ms, Ms^Xm, Ms^Xm, Ms^Xm
Aa, Aa^Fma, Aa^Fma, Ha^Fma, Aa^Fma, Aa^Fma, Aa^Fma, Aa, Aa^Fma, Aa^Fpa, Aa^Fma, Aa^Fma, Aa^Fma, Aa^Fma, Aa^Fma, Gll^Fp, Aa^Fma, Gll^Fp, Gll^Fp, Gll^Fp, Cv, Gs, Gs, Re, Re, Re, Re, Re, Re, Re, Re, Aa^Fma, Aa^Fma, Aa^Fma, Ha^Fma, Aa^Fma, Gs, Aa, Aa^Fpa, Aa^Fpa, Aa, Ms, Ms, Ms, Ms, Ms^Xm
Aa, Aa^Fma, Gll^Fmw, Aa^Fma, Aa^Fma, Aa^Fma, Aa^Fma, Aa^Fma, Aa^Vea, Aa^Fma, Gs, Aa^Fma, Gll^Fmw, Aa, Aa^Fma, Aa^Fma, Gll^Fmw, Gll^Fmw, Cv, Cv, 2 Kv, Cv, Gll^Fmw, Aa, Gll^Fp, Re, Gll^Fp, Re, Re, Re, Re, Gll^Fmw, Gll^Fp, Gll^Fp, Aa^Fma, Aa^Fma, Ha, Ha, Ha^Fpa, Aa^Fpa, Ms, Ms, Ms, Ms, Ha, Ms
Gs, Gll^Fmw, Gll^Fmw, Gll^Fmw, Gll^Fmw, Aa^Fma, Gll^Fmw, Aa^Fma, Aa^Fma, Gll^Fp, Gll^Fp, Gll^Fp, Gll^Fmw, Gll^Fp, Aa^Fma, Aa^Fma, Gll^Fmw, Gll^Fmw, Cv, Cv, Cv, Cv, Aa, Aa, Aa, Gll^Fp, Gll^Fp, Re, Gll^Fp, Re, Re, Re, Re, Gll^Fmw, Gll^Fp, Ha, Aa^Fma, Ha^Fpa, Ha^Fpa, Aa, Aa, Ms, Ha^Fpa, Ha^Fpa, Ha^Fpa, Ha
Gll^Fmw, Gll^Fmw, Gs, Gll^Fmw, Gll^Fp, Gll^Fp, Gll^Fp, Aa^Fma, Gll^Fmw, Aa^Fma, Gll^Fp, Gll^Fmw, Gll^Fmw, Gll^Fmw, Gll^Fp, Aa^Vea, Gll^Fp, Gll^Fmw, Gll^Fmw, Cv, Cv, Cv, Gs, Gs, Gll^Fmw, Aa, Aa, Cv, Cv, Re, Re, Re, Re, Cv, Cv, Gll^Fp, Gll^Fp, Gll^Fp, Gll^Fp, Aa^Vea, Gll^Fp, Gll^Fp, Aa, Aa^Fpa, Ha, Ha
Gll^Fmw, Gll^Fmw, Gll^Fmw, Gll^Fmw, Gll^Fmw, Gll^Fp, Gll^Fp, Gll^Fmw, Aa, Aa, Gll^Fp, Gll^Fp, Gs, Gll^Fp, Gs, Gs, Gs, Aa, Gs, Gs, Gs, Gll^Fmw, Gs, Gs, Gs, Gll^Fmw, Gll^Fmw, Gll^Fmw, Gll^Fmw, Gs, Gs, Re, Re, Re, Re, Gll^Fp, Gs, Gll^Fp, Gll^Fp, Gll^Fp, Gll^Fp, Gll^Fmw, Gll^Fmw, Aa, Gs, Gs